CustomerID,Recency,Frequency,MonetaryValue,R,F,M,RFM_Score,RFM_Segment
12346,326,1,77183.6,1,1,3,5,113
12347,2,182,4310,3,3,3,9,333
12348,75,31,1797.24,2,2,3,7,223
12349,19,73,1757.55,3,3,3,9,333
12350,310,17,334.4,1,1,1,3,111
12352,36,85,2506.04,2,3,3,8,233
12353,204,4,89,1,1,1,3,111
12354,232,58,1079.4,1,2,2,5,122
12355,214,13,459.4,1,1,2,4,112
12356,23,59,2811.43,3,2,3,8,323
12357,33,131,6207.67,2,3,3,8,233
12358,2,19,1168.06,3,1,2,6,312
12359,58,245,6310.03,2,3,3,8,233
12360,52,129,2662.06,2,3,3,8,233
12361,287,10,189.9,1,1,1,3,111
12362,3,266,5226.23,3,3,3,9,333
12363,110,23,552,1,1,2,4,112
12364,8,85,1313.1,3,3,3,9,333
12365,291,22,641.38,1,1,2,4,112
12367,4,11,168.9,3,1,1,5,311
12370,51,166,3541.94,2,3,3,8,233
12371,45,63,1887.96,2,2,3,7,223
12372,72,52,1298.04,2,2,3,7,223
12373,311,14,364.6,1,1,1,3,111
12374,25,33,742.93,3,2,2,7,322
12375,11,17,457.5,3,1,2,6,312
12377,315,77,1628.12,1,3,3,7,133
12378,130,219,4008.62,1,3,3,7,133
12379,82,40,852.24,2,2,2,6,222
12380,22,104,2724.81,3,3,3,9,333
12381,5,87,1845.31,3,3,3,9,333
12383,185,99,1850.56,1,3,3,7,133
12384,29,27,585.27,2,2,2,6,222
12386,338,10,401.9,1,1,2,4,112
12388,16,100,2780.66,3,3,3,9,333
12390,80,32,549.84,2,2,2,6,222
12391,22,93,439.66,3,3,2,8,332
12393,72,64,1582.6,2,2,3,7,223
12394,64,27,1272.48,2,2,3,7,223
12395,19,156,3018.63,3,3,3,9,333
12397,36,126,2409.9,2,3,3,8,233
12398,46,85,1635.66,2,3,3,8,233
12399,119,59,1108.65,1,2,2,5,122
12401,303,5,84.3,1,1,1,3,111
12402,323,11,225.6,1,1,1,3,111
12403,50,5,427.7,2,1,2,5,212
12405,149,54,1710.39,1,2,3,6,123
12406,22,105,3415.3,3,3,3,9,333
12407,50,77,1708.12,2,3,3,8,233
12408,33,105,2888.55,2,3,3,8,233
12409,79,109,11072.67,2,3,3,8,233
12410,309,26,693.33,1,2,2,5,122
12412,75,61,1226.88,2,2,3,7,223
12413,67,38,758.1,2,2,2,6,222
12414,217,18,562.41,1,1,2,4,112
12415,24,714,124914.53,3,3,3,9,333
12417,3,192,3649.1,3,3,3,9,333
12418,113,34,668.58,1,2,2,5,122
12420,64,29,600.39,2,2,2,6,222
12421,16,45,807.04,3,2,2,7,322
12422,96,39,803.56,1,2,2,5,122
12423,1,125,1859.31,3,3,3,9,333
12424,163,30,1760.96,1,2,3,6,123
12425,78,36,777.2,2,2,2,6,222
12426,195,30,582.73,1,2,2,5,122
12427,22,31,825.8,3,2,2,7,322
12428,26,294,7956.46,2,3,3,8,233
12429,9,97,3750.4,3,3,3,9,333
12430,43,11,256.4,2,1,1,4,211
12431,36,234,6419.95,2,3,3,8,233
12432,43,108,5059.32,2,3,3,8,233
12433,1,420,13375.87,3,3,3,9,333
12434,85,50,806.14,2,2,2,6,222
12435,80,36,7829.89,2,2,3,7,223
12436,100,16,509.01,1,1,2,4,112
12437,2,199,4951.41,3,3,3,9,333
12438,14,98,2906.85,3,3,3,9,333
12441,367,11,173.55,1,1,1,3,111
12442,3,12,172.06,3,1,1,5,311
12444,21,176,5005.46,3,3,3,9,333
12445,22,4,133.4,3,1,1,5,311
12446,58,57,1002.31,2,2,2,6,222
12447,243,26,476.49,1,2,2,5,122
12448,44,22,449.45,2,1,2,5,212
12449,22,191,4067.29,3,3,3,9,333
12450,156,8,197.88,1,1,1,3,111
12451,11,354,9035.52,3,3,3,9,333
12452,17,22,430.57,3,1,2,6,312
12453,134,43,707.09,1,2,2,5,122
12454,56,15,3528.34,2,1,3,6,213
12455,73,90,2466.86,2,3,3,8,233
12456,44,125,3181.04,2,3,3,8,233
12457,66,62,2363.23,2,2,3,7,223
12458,71,38,947.4,2,2,2,6,222
12461,94,35,826.88,1,2,2,5,122
12462,19,62,1189.59,3,2,2,7,322
12463,53,83,1344.78,2,3,3,8,233
12464,10,29,1212.05,3,2,3,8,323
12465,17,47,742.19,3,2,2,7,322
12468,188,38,729.54,1,2,2,5,122
12471,2,459,19788.65,3,3,3,9,333
12472,32,339,6572.11,2,3,3,8,233
12473,29,167,3928.05,2,3,3,8,233
12474,17,422,7324.09,3,3,3,9,333
12475,54,36,723.38,2,2,2,6,222
12476,16,233,6816.42,3,3,3,9,333
12477,23,300,13219.74,3,3,3,9,333
12478,4,36,680.99,3,2,2,7,322
12479,11,31,527.2,3,2,2,7,322
12480,28,154,3281.63,2,3,3,8,233
12481,23,216,5579.82,3,3,3,9,333
12483,17,75,2484.98,3,3,3,9,333
12484,33,343,4527.32,2,3,3,8,233
12488,10,55,1298.66,3,2,3,8,323
12489,336,15,334.93,1,1,1,3,111
12490,5,245,5417.93,3,3,3,9,333
12491,39,26,460.4,2,2,2,6,222
12492,63,20,263.21,2,1,1,4,211
12493,166,22,433.74,1,1,2,4,112
12494,16,77,1246.1,3,3,3,9,333
12497,82,14,1043.1,2,1,2,5,212
12498,21,23,403.7,3,1,2,6,312
12500,23,61,4257.82,3,2,3,8,323
12501,337,149,2169.39,1,3,3,7,133
12502,96,147,3723.87,1,3,3,7,133
12504,18,9,482.05,3,1,2,6,312
12506,233,23,73.5,1,1,1,3,111
12507,134,21,1304.81,1,1,3,5,113
12508,26,68,397.88,2,2,2,6,222
12509,284,7,176.5,1,1,1,3,111
12510,143,33,982.57,1,2,2,5,122
12512,66,31,132.18,2,2,1,5,221
12513,113,35,612.29,1,2,2,5,122
12514,267,51,1017.68,1,2,2,5,122
12515,353,16,383.7,1,1,1,3,111
12516,78,26,1312.06,2,2,3,7,223
12517,28,279,2481.6,2,3,3,8,233
12518,1,124,2056.89,3,3,3,9,333
12519,64,17,330.84,2,1,1,4,211
12520,79,152,2634.26,2,3,3,8,233
12521,143,38,599.68,1,2,2,5,122
12522,39,12,192.72,2,1,1,4,211
12523,19,106,1789.77,3,3,3,9,333
12524,9,144,4485.72,3,3,3,9,333
12526,1,71,1316.66,3,2,3,8,323
12527,82,18,348.71,2,1,1,4,211
12528,9,92,1933.48,3,3,3,9,333
12530,60,66,1662.28,2,2,3,7,223
12531,15,17,125.22,3,1,1,5,311
12532,30,16,349.83,2,1,1,4,211
12534,131,63,1089.18,1,2,2,5,122
12535,92,34,716.35,1,2,2,5,122
12536,43,261,12601.83,2,3,3,8,233
12538,29,21,363.95,2,1,1,4,211
12539,22,273,5568.35,3,3,3,9,333
12540,20,478,13400.24,3,3,3,9,333
12541,30,52,981.18,2,2,2,6,222
12544,36,19,372.7,2,1,1,4,211
12545,75,50,1000.39,2,2,2,6,222
12546,47,69,1161.5,2,2,2,6,222
12547,198,8,207.8,1,1,1,3,111
12548,166,5,95.2,1,1,1,3,111
12550,79,57,964.83,2,2,2,6,222
12551,358,10,168,1,1,1,3,111
12552,39,20,437.82,2,1,2,5,212
12553,8,191,3692.28,3,3,3,9,333
12556,50,119,599.56,2,3,2,7,232
12557,16,33,11990.96,3,2,3,8,323
12558,8,11,269.96,3,1,1,5,311
12559,311,21,561.71,1,1,2,4,112
12560,5,105,2134.01,3,3,3,9,333
12561,303,16,238.85,1,1,1,3,111
12562,8,168,3781.74,3,3,3,9,333
12564,261,21,456.9,1,1,2,4,112
12565,289,9,145.92,1,1,1,3,111
12566,86,19,351.65,2,1,1,4,211
12567,23,446,9401.28,3,3,3,9,333
12569,2,188,4124.69,3,3,3,9,333
12571,40,34,519.61,2,2,2,6,222
12572,9,60,1020.42,3,2,2,7,322
12573,227,28,160.54,1,2,1,4,121
12574,316,11,218.45,1,1,1,3,111
12576,36,88,1315.83,2,3,3,8,233
12577,35,146,626.6,2,3,2,7,232
12578,21,114,2794.51,3,3,3,9,333
12579,78,29,440.42,2,2,2,6,222
12580,247,24,415.7,1,2,2,5,122
12581,40,15,197.71,2,1,1,4,211
12582,239,22,511.36,1,1,2,4,112
12583,3,247,7281.38,3,3,3,9,333
12584,4,96,2338.15,3,3,3,9,333
12585,234,87,2040.1,1,3,3,7,133
12586,17,11,196.94,3,1,1,5,311
12587,8,4,144,3,1,1,5,311
12588,39,10,214.9,2,1,1,4,211
12589,29,35,646.68,2,2,2,6,222
12590,211,68,9864.26,1,2,3,6,123
12591,317,26,452.85,1,2,2,5,122
12592,92,18,437.6,1,1,2,4,112
12593,109,21,418.1,1,1,2,4,112
12594,38,118,3338.22,2,3,3,8,233
12596,51,27,618.27,2,2,2,6,222
12597,19,206,3811.22,3,3,3,9,333
12598,10,132,3023.08,3,3,3,9,333
12599,29,62,1032.58,2,2,2,6,222
12600,29,64,2599.04,2,2,3,7,223
12601,190,28,577.06,1,2,2,5,122
12602,59,12,153.12,2,1,1,4,211
12603,22,2,739.2,3,1,2,6,312
12604,79,16,254.18,2,1,1,4,211
12607,60,101,1579.51,2,3,3,8,233
12609,78,60,1126.85,2,2,2,6,222
12610,23,106,2099.54,3,3,3,9,333
12611,52,65,1193.32,2,2,3,7,223
12612,74,19,704.04,2,1,2,5,212
12613,57,153,3344.38,2,3,3,8,233
12614,278,20,315.6,1,1,1,3,111
12615,2,105,2291.19,3,3,3,9,333
12616,95,32,713.3,1,2,2,5,122
12617,29,41,352.98,2,2,1,5,221
12618,22,11,177.31,3,1,1,5,311
12619,16,90,3641.24,3,3,3,9,333
12620,15,92,1339.41,3,3,3,9,333
12621,2,467,13689.67,3,3,3,9,333
12622,232,11,180.1,1,1,1,3,111
12623,276,18,305.1,1,1,1,3,111
12624,106,38,641.13,1,2,2,5,122
12625,212,86,2683.82,1,3,3,7,133
12626,23,294,6620.48,3,3,3,9,333
12627,11,230,4478.53,3,3,3,9,333
12628,4,41,786.46,3,2,2,7,322
12630,10,64,1270.88,3,2,3,8,323
12631,57,31,640.5,2,2,2,6,222
12633,59,101,2163.98,2,3,3,8,233
12635,90,101,1689.18,2,3,3,8,233
12637,67,382,6002.9,2,3,3,8,233
12638,33,39,671.69,2,2,2,6,222
12639,239,22,486.1,1,1,2,4,112
12640,24,53,1174.58,3,2,2,7,322
12641,115,10,185.9,1,1,1,3,111
12642,25,47,1013.26,3,2,2,7,322
12643,128,24,3344.64,1,2,3,6,123
12644,130,31,477.91,1,2,2,5,122
12645,34,73,1775.18,2,3,3,8,233
12646,5,45,1346.97,3,2,3,8,323
12647,22,121,3722.82,3,3,3,9,333
12648,155,21,318.05,1,1,1,3,111
12649,107,31,623.51,1,2,2,5,122
12650,3,20,314.44,3,1,1,5,311
12651,335,9,114,1,1,1,3,111
12652,331,48,919.98,1,2,2,5,122
12653,149,43,2209.85,1,2,3,6,123
12654,11,38,601.98,3,2,2,7,322
12656,17,126,4051.17,3,3,3,9,333
12657,11,47,1643.18,3,2,3,8,323
12658,19,36,686.05,3,2,2,7,322
12659,30,5,91.68,2,1,1,4,211
12660,11,13,245.1,3,1,1,5,311
12662,1,230,3849.78,3,3,3,9,333
12664,8,37,4881.88,3,2,3,8,323
12665,325,3,63,1,1,1,3,111
12667,58,33,620.13,2,2,2,6,222
12668,12,161,3807.15,3,3,3,9,333
12669,151,101,2744.03,1,3,3,7,133
12670,10,92,2996.05,3,3,3,9,333
12672,330,10,225.9,1,1,1,3,111
12673,5,42,610.52,3,2,2,7,322
12674,39,83,1970.6,2,3,3,8,233
12676,25,45,1331.39,3,2,3,8,323
12678,42,165,17628.46,2,3,3,8,233
12679,59,48,1113.02,2,2,2,6,222
12680,1,52,862.81,3,2,2,7,322
12681,15,638,13787.54,3,3,3,9,333
12682,4,524,12279.82,3,3,3,9,333
12683,4,344,8476.57,3,3,3,9,333
12684,8,105,2283.63,3,3,3,9,333
12685,28,157,2863.08,2,3,3,8,233
12686,372,7,89.14,1,1,1,3,111
12688,114,171,4873.81,1,3,3,7,133
12689,26,72,1247.61,2,2,3,7,223
12690,206,16,389.01,1,1,2,4,112
12691,28,32,1035.8,2,2,2,6,222
12693,127,39,855.91,1,2,2,5,122
12694,70,37,869.67,2,2,2,6,222
12695,7,27,582.1,3,2,2,7,322
12697,29,41,957.59,2,2,2,6,222
12700,8,268,4939.99,3,3,3,9,333
12701,80,53,797.71,2,2,2,6,222
12702,20,12,219,3,1,1,5,311
12703,71,21,283.55,2,1,1,4,211
12704,7,88,2340.84,3,3,3,9,333
12705,15,334,6868.29,3,3,3,9,333
12707,292,33,603.42,1,2,2,5,122
12708,30,157,2712.91,2,3,3,8,233
12709,15,207,9706.52,3,3,3,9,333
12710,97,77,1149.02,1,3,2,6,132
12712,29,133,4396.13,2,3,3,8,233
12713,1,38,848.55,3,2,2,7,322
12714,9,259,4708.86,3,3,3,9,333
12715,106,20,343.36,1,1,1,3,111
12716,4,69,1053.49,3,2,2,7,322
12717,151,55,1030.98,1,2,2,5,122
12718,71,19,238.25,2,1,1,4,211
12719,5,39,644.95,3,2,2,7,322
12720,3,354,5781.73,3,3,3,9,333
12721,32,161,2656.13,2,3,3,8,233
12722,85,53,997.63,2,2,2,6,222
12723,4,69,725.07,3,2,2,7,322
12724,5,53,1031.41,3,2,2,7,322
12725,371,24,427.8,1,2,2,5,122
12726,28,124,2609.1,2,3,3,8,233
12727,11,139,3980.7,3,3,3,9,333
12728,71,46,836.33,2,2,2,6,222
12729,114,26,453.01,1,2,2,5,122
12731,24,274,18895.91,3,3,3,9,333
12732,180,12,236.26,1,1,1,3,111
12733,234,22,383.95,1,1,1,3,111
12734,353,4,110.4,1,1,1,3,111
12735,315,43,779.57,1,2,2,5,122
12736,333,4,234,1,1,1,3,111
12738,372,11,155.35,1,1,1,3,111
12739,78,38,1013.04,2,2,2,6,222
12740,64,27,427.6,2,2,2,6,222
12743,134,131,540.13,1,3,2,6,132
12744,52,222,21279.29,2,3,3,8,233
12747,2,103,4196.01,3,3,3,9,333
12748,1,4412,33053.19,3,3,3,9,333
12749,4,199,4090.88,3,3,3,9,333
12750,129,15,275.88,1,1,1,3,111
12752,81,53,4366.78,2,2,3,7,223
12753,23,197,21429.39,3,3,3,9,333
12754,236,63,3010.74,1,2,3,6,123
12755,281,4,3811.95,1,1,3,5,113
12756,87,4,112.08,2,1,1,4,211
12757,16,364,7834.65,3,3,3,9,333
12758,117,97,2791.59,1,3,3,7,133
12759,52,95,1531.44,2,3,3,8,233
12762,8,69,1898.52,3,2,3,8,323
12763,138,18,494.08,1,1,2,4,112
12764,317,45,1693.88,1,2,3,6,123
12766,4,310,6989.63,3,3,3,9,333
12769,239,32,1143.6,1,2,2,5,122
12770,211,12,1351.45,1,1,3,5,113
12772,60,55,892.47,2,2,2,6,222
12775,17,66,1386.04,3,2,3,8,323
12778,20,50,822.23,3,2,2,7,322
12779,38,149,3981.36,2,3,3,8,233
12781,64,25,826.74,2,2,2,6,222
12782,5,103,2330.92,3,3,3,9,333
12783,2,84,2225.91,3,3,3,9,333
12784,9,57,532.82,3,2,2,7,322
12785,364,14,311.95,1,1,1,3,111
12787,10,20,463.66,3,1,2,6,312
12789,65,4,91.85,2,1,1,4,211
12790,192,21,324.92,1,1,1,3,111
12791,374,2,192.6,1,1,1,3,111
12792,257,25,400.54,1,2,2,5,122
12793,335,24,545.48,1,2,2,5,122
12794,53,45,860.41,2,2,2,6,222
12795,19,14,430.48,3,1,2,6,312
12797,366,13,254.03,1,1,1,3,111
12798,10,8,6977.04,3,1,3,7,313
12802,187,25,427.58,1,2,2,5,122
12808,37,28,483.65,2,2,2,6,222
12809,178,25,489.31,1,2,2,5,122
12811,261,31,514.85,1,2,2,5,122
12812,45,15,229.64,2,1,1,4,211
12814,102,2,125.92,1,1,1,3,111
12815,148,47,1063.46,1,2,2,5,122
12816,96,29,572.2,1,2,2,5,122
12817,281,4,166.04,1,1,1,3,111
12818,262,14,1542.08,1,1,3,5,113
12820,3,59,942.34,3,2,2,7,322
12821,214,6,92.72,1,1,1,3,111
12822,71,46,948.88,2,2,2,6,222
12823,75,5,1759.5,2,1,3,6,213
12824,60,25,397.12,2,2,2,6,222
12826,3,91,1474.72,3,3,3,9,333
12827,6,25,430.15,3,2,2,7,322
12828,3,56,1018.71,3,2,2,7,322
12829,337,11,293,1,1,1,3,111
12830,38,38,6814.64,2,2,3,7,223
12831,262,9,215.05,1,1,1,3,111
12832,32,27,383.03,2,2,1,5,221
12833,145,24,417.38,1,2,2,5,122
12834,283,18,312.38,1,1,1,3,111
12836,59,174,2610.36,2,3,3,8,233
12837,173,12,134.1,1,1,1,3,111
12838,34,120,671.95,2,3,2,7,232
12839,3,314,5591.42,3,3,3,9,333
12840,144,113,2726.77,1,3,3,7,133
12841,5,414,3991.58,3,3,3,9,333
12842,70,34,1118.99,2,2,2,6,222
12843,66,103,1702.26,2,3,3,8,233
12844,29,52,325.96,2,2,1,5,221
12845,267,27,354.09,1,2,1,4,121
12847,22,84,843.64,3,3,2,8,332
12849,31,48,1010.29,2,2,2,6,222
12851,97,47,131.81,1,2,1,4,121
12852,295,17,311.55,1,1,1,3,111
12853,135,78,1957.1,1,3,3,7,133
12854,79,109,1316.25,2,3,3,8,233
12855,373,3,38.1,1,1,1,3,111
12856,8,311,2170.78,3,3,3,9,333
12857,211,46,1106.4,1,2,2,5,122
12863,52,5,521.2,2,1,2,5,212
12864,138,3,147.12,1,1,1,3,111
12865,26,95,1568.23,2,3,3,8,233
12866,283,26,559.12,1,2,2,5,122
12867,26,534,4009.34,2,3,3,8,233
12868,186,107,1607.06,1,3,3,7,133
12871,84,11,380.64,2,1,1,4,211
12872,327,66,599.97,1,2,2,5,122
12873,282,4,374,1,1,1,3,111
12875,143,2,343.23,1,1,1,3,111
12876,58,85,2218.02,2,3,3,8,233
12877,4,154,1535.77,3,3,3,9,333
12878,236,47,854.99,1,2,2,5,122
12879,45,10,573.22,2,1,2,5,212
12881,276,7,298,1,1,1,3,111
12882,9,13,1463.04,3,1,3,7,313
12883,25,42,703.47,3,2,2,7,322
12884,88,7,309.05,2,1,1,4,211
12885,63,71,1175.22,2,2,2,6,222
12886,68,82,1378.4,2,3,3,8,233
12888,214,5,354.12,1,1,1,3,111
12890,24,79,376.72,3,3,1,7,331
12891,186,3,331,1,1,1,3,111
12893,31,31,176.55,2,2,1,5,221
12895,42,22,372.8,2,1,1,4,211
12897,205,4,216.5,1,1,1,3,111
12901,9,116,17654.54,3,3,3,9,333
12902,265,10,138.68,1,1,1,3,111
12904,18,71,496.06,3,2,2,7,322
12906,12,63,2919.81,3,2,3,8,323
12908,176,2,750,1,1,2,4,112
12909,40,91,2178.67,2,3,3,8,233
12910,23,75,3075.04,3,3,3,9,333
12912,3,24,1662.3,3,2,3,8,323
12913,5,50,2483.63,3,2,3,8,323
12915,149,22,363.65,1,1,1,3,111
12916,139,103,2944.95,1,3,3,7,133
12917,128,2,594,1,1,2,4,112
12919,8,50,1335.19,3,2,3,8,323
12920,17,27,162.78,3,2,1,6,321
12921,9,720,16587.09,3,3,3,9,333
12922,161,28,405.38,1,2,2,5,122
12923,64,28,172.82,2,2,1,5,221
12924,88,30,933.7,2,2,2,6,222
12925,5,45,694.05,3,2,2,7,322
12928,35,84,2062.7,2,3,3,8,233
12929,312,8,117.85,1,1,1,3,111
12930,78,25,415.8,2,2,2,6,222
12931,22,82,42055.96,3,3,3,9,333
12933,24,106,607.53,3,3,2,8,332
12935,2,129,2160.7,3,3,3,9,333
12936,17,62,1063.9,3,2,2,7,322
12937,15,120,1504.27,3,3,3,9,333
12938,26,9,114.14,2,1,1,4,211
12939,64,47,11581.8,2,2,3,7,223
12940,55,96,899.69,2,3,2,7,232
12942,131,70,675.6,1,2,2,5,122
12944,36,30,604.51,2,2,2,6,222
12945,288,23,462.95,1,1,2,4,112
12947,144,97,1603.99,1,3,3,7,133
12948,16,116,2064.95,3,3,3,9,333
12949,31,215,4167.22,2,3,3,8,233
12950,2,23,1843,3,1,3,7,313
12951,9,63,1064.07,3,2,2,7,322
12952,6,79,1387.79,3,3,3,9,333
12953,10,17,329.85,3,1,1,5,311
12955,1,180,4757.16,3,3,3,9,333
12956,306,19,108.07,1,1,1,3,111
12957,10,238,4017.54,3,3,3,9,333
12962,7,16,266.39,3,1,1,5,311
12963,8,95,1856.63,3,3,3,9,333
12965,89,108,769.81,2,3,2,7,232
12966,10,10,160.18,3,1,1,5,311
12967,358,19,1660.9,1,1,3,5,113
12968,112,5,135.95,1,1,1,3,111
12970,7,129,405.47,3,3,2,8,332
12971,4,305,11189.91,3,3,3,9,333
12974,198,8,144.8,1,1,1,3,111
12976,212,22,738.6,1,1,2,4,112
12977,156,9,39.24,1,1,1,3,111
12980,158,20,7374.9,1,1,3,5,113
12981,30,20,372.22,2,1,1,4,211
12982,243,28,390.54,1,2,2,5,122
12984,19,4,97.5,3,1,1,5,311
12985,1,76,1239.38,3,3,3,9,333
12987,74,28,558.7,2,2,2,6,222
12988,292,83,505.82,1,3,2,6,132
12989,3,64,6924.11,3,2,3,8,323
12990,31,13,409.5,2,1,2,5,212
12991,23,31,503.76,3,2,2,7,322
12993,23,27,414.76,3,2,2,7,322
12994,4,61,974.42,3,2,2,7,322
12995,85,3,211.32,2,1,1,4,211
12997,22,59,1226.89,3,2,3,8,323
12999,196,28,455.88,1,2,2,5,122
13000,107,31,534.85,1,2,2,5,122
13001,4,337,9785.97,3,3,3,9,333
13002,318,7,120.95,1,1,1,3,111
13003,106,6,149.05,1,1,1,3,111
13004,12,404,5655.91,3,3,3,9,333
13005,174,26,513.7,1,2,2,5,122
13006,56,4,81.57,2,1,1,4,211
13008,323,14,229.47,1,1,1,3,111
13011,372,3,50.55,1,1,1,3,111
13012,9,88,1646.84,3,3,3,9,333
13013,1,219,4810.94,3,3,3,9,333
13014,11,109,3466.28,3,3,3,9,333
13015,53,175,3339.64,2,3,3,8,233
13016,73,47,789.89,2,2,2,6,222
13017,7,1,204,3,1,1,5,311
13018,16,458,7277.7,3,3,3,9,333
13021,4,131,2616.38,3,3,3,9,333
13023,64,40,689.9,2,2,2,6,222
13026,1,40,975.36,3,2,2,7,322
13027,114,26,6912,1,2,3,6,123
13028,23,45,661.32,3,2,2,7,322
13029,31,10,1247.5,2,1,3,6,213
13030,11,92,752.44,3,3,2,8,332
13032,52,71,1010.18,2,2,2,6,222
13033,357,11,190.55,1,1,1,3,111
13034,55,37,642.77,2,2,2,6,222
13035,74,27,921.88,2,2,2,6,222
13037,138,48,881.07,1,2,2,5,122
13038,80,28,908.46,2,2,2,6,222
13040,9,43,676.99,3,2,2,7,322
13043,273,13,516.42,1,1,2,4,112
13044,291,33,560.47,1,2,2,5,122
13045,99,18,305.28,1,1,1,3,111
13046,31,35,629.31,2,2,2,6,222
13047,32,172,3237.54,2,3,3,8,233
13048,14,135,1819.41,3,3,3,9,333
13049,64,14,656.68,2,1,2,5,212
13050,15,403,5836.86,3,3,3,9,333
13052,212,18,348.15,1,1,1,3,111
13055,78,76,1214.41,2,3,3,8,233
13058,25,8,271.4,3,1,1,5,311
13059,250,8,183.4,1,1,1,3,111
13060,254,15,307.53,1,1,1,3,111
13061,72,10,248.61,2,1,1,4,211
13062,191,11,346.98,1,1,1,3,111
13064,13,68,1105.59,3,2,2,7,322
13065,373,14,205.86,1,1,1,3,111
13066,24,48,470.8,3,2,2,7,322
13067,82,15,115.46,2,1,1,4,211
13068,10,2,344,3,1,1,5,311
13069,1,424,4431.44,3,3,3,9,333
13070,192,9,228.8,1,1,1,3,111
13072,267,7,177.15,1,1,1,3,111
13075,130,22,919.61,1,1,2,4,112
13077,1,111,728.02,3,3,2,8,332
13078,3,358,12627.94,3,3,3,9,333
13079,4,6,220.1,3,1,1,5,311
13080,179,6,58.08,1,1,1,3,111
13081,12,1024,28337.38,3,3,3,9,333
13082,126,73,3613.63,1,3,3,7,133
13083,4,18,303.75,3,1,1,5,311
13085,158,22,416.08,1,1,2,4,112
13089,3,1814,58762.08,3,3,3,9,333
13090,9,155,8910.82,3,3,3,9,333
13091,28,21,345.82,2,1,1,4,211
13092,71,25,477.83,2,2,2,6,222
13093,276,159,7832.47,1,3,3,7,133
13094,21,24,1927.32,3,2,3,8,323
13095,71,6,74.4,2,1,1,4,211
13097,33,421,6003.22,2,3,3,8,233
13098,1,572,28882.44,3,3,3,9,333
13099,99,1,207.36,1,1,1,3,111
13101,234,8,101.19,1,1,1,3,111
13102,1,304,6424.09,3,3,3,9,333
13103,40,8,243.94,2,1,1,4,211
13104,3,20,1098.48,3,1,2,6,312
13106,133,1,76.5,1,1,1,3,111
13107,44,58,1531.62,2,2,3,7,223
13108,373,10,350.06,1,1,1,3,111
13109,60,47,786.54,2,2,2,6,222
13110,31,145,1488.67,2,3,3,8,233
13113,1,200,12245.96,3,3,3,9,333
13115,12,120,2294.78,3,3,3,9,333
13116,138,30,501.14,1,2,2,5,122
13117,22,76,984.91,3,3,2,8,332
13118,20,79,1197.81,3,3,3,9,333
13120,239,1,30.6,1,1,1,3,111
13121,269,50,283.73,1,2,1,4,121
13122,94,55,922.39,1,2,2,5,122
13124,90,222,3756.33,2,3,3,8,233
13126,5,140,2099.64,3,3,3,9,333
13127,78,15,259.17,2,1,1,4,211
13130,94,2,64,1,1,1,3,111
13131,23,44,1073.3,3,2,2,7,322
13132,262,3,77.3,1,1,1,3,111
13133,274,7,109.8,1,1,1,3,111
13134,86,98,1793.58,2,3,3,8,233
13135,197,1,3096,1,1,3,5,113
13136,56,127,2607.61,2,3,3,8,233
13137,11,687,3603.29,3,3,3,9,333
13138,22,63,962.39,3,2,2,7,322
13139,16,170,5064.94,3,3,3,9,333
13140,108,45,422.47,1,2,2,5,122
13141,85,135,2388.75,2,3,3,8,233
13142,19,23,307.09,3,1,1,5,311
13144,333,3,110.95,1,1,1,3,111
13145,40,6,618.52,2,1,2,5,212
13146,26,17,228.91,2,1,1,4,211
13147,10,4,712.8,3,1,2,6,312
13148,29,312,3683.26,2,3,3,8,233
13149,14,86,1676.06,3,3,3,9,333
13151,296,74,1257.87,1,3,3,7,133
13153,6,15,486.22,3,1,2,6,312
13155,33,85,971.76,2,3,2,7,232
13157,49,87,1741.22,2,3,3,8,233
13158,95,79,1201.06,1,3,3,7,133
13159,9,120,1429.35,3,3,3,9,333
13160,22,4,91.8,3,1,1,5,311
13161,313,8,112.75,1,1,1,3,111
13162,122,79,1688.29,1,3,3,7,133
13165,46,42,1021.48,2,2,2,6,222
13166,283,41,417.2,1,2,2,5,122
13167,19,65,791.33,3,2,2,7,322
13168,36,126,1299.59,2,3,3,8,233
13169,64,13,712.88,2,1,2,5,212
13170,27,30,108.81,2,2,1,5,221
13171,22,46,468.41,3,2,2,7,322
13173,4,43,353.65,3,2,1,6,321
13174,16,293,2742.82,3,3,3,9,333
13176,46,67,481.49,2,2,2,6,222
13177,65,17,282.45,2,1,1,4,211
13178,26,265,5725.47,2,3,3,8,233
13182,45,11,121.18,2,1,1,4,211
13183,8,94,3957.78,3,3,3,9,333
13184,15,179,1668.95,3,3,3,9,333
13185,268,1,71.4,1,1,1,3,111
13186,40,79,1575.89,2,3,3,8,233
13187,337,37,236.02,1,2,1,4,121
13188,11,2,114.6,3,1,1,5,311
13189,19,29,260.68,3,2,1,6,321
13192,95,63,911.94,1,2,2,5,122
13193,61,25,112.08,2,2,1,5,221
13194,136,3,60.7,1,1,1,3,111
13196,11,110,1797.78,3,3,3,9,333
13198,10,226,3401.24,3,3,3,9,333
13199,4,119,9817.12,3,3,3,9,333
13200,19,46,870.09,3,2,2,7,322
13203,10,57,869.46,3,2,2,7,322
13207,15,8,250.26,3,1,1,5,311
13208,59,148,1217.65,2,3,3,8,233
13209,30,321,5891.61,2,3,3,8,233
13210,94,22,353.48,1,1,1,3,111
13211,10,55,1095.42,3,2,2,7,322
13212,20,141,786.83,3,3,2,8,332
13213,57,90,1520.58,2,3,3,8,233
13216,268,5,333.74,1,1,1,3,111
13217,122,4,533.98,1,1,2,4,112
13218,127,5,62.64,1,1,1,3,111
13220,78,21,819.29,2,1,2,5,212
13221,240,66,847.41,1,2,2,5,122
13223,200,5,163.2,1,1,1,3,111
13224,60,108,2155.95,2,3,3,8,233
13225,3,32,6463.84,3,2,3,8,323
13226,273,16,108.21,1,1,1,3,111
13227,202,9,257.7,1,1,1,3,111
13228,81,2,358,2,1,1,4,211
13229,226,10,160.95,1,1,1,3,111
13230,4,587,2755.63,3,3,3,9,333
13232,13,202,1328.35,3,3,3,9,333
13233,74,43,605.12,2,2,2,6,222
13235,212,58,1031.07,1,2,2,5,122
13236,25,36,744.85,3,2,2,7,322
13238,17,31,700.73,3,2,2,7,322
13239,262,21,329.56,1,1,1,3,111
13240,96,67,663.65,1,2,2,5,122
13242,112,13,270.4,1,1,1,3,111
13243,203,57,585.12,1,2,2,5,122
13244,93,27,121.74,1,2,1,4,121
13245,51,16,430.5,2,1,2,5,212
13246,18,136,1961.52,3,3,3,9,333
13247,18,25,501.12,3,2,2,7,322
13248,125,26,465.68,1,2,2,5,122
13249,92,23,711.41,1,1,2,4,112
13253,157,36,1030.4,1,2,2,5,122
13255,9,13,399.51,3,1,2,6,312
13258,12,36,672.83,3,2,2,7,322
13259,62,81,283.18,2,3,1,6,231
13260,61,8,557.62,2,1,2,5,212
13261,269,9,944.1,1,1,2,4,112
13262,263,11,200.29,1,1,1,3,111
13263,1,1667,7436.93,3,3,3,9,333
13265,53,90,2092.66,2,3,3,8,233
13266,11,187,3834.26,3,3,3,9,333
13267,3,211,4521.49,3,3,3,9,333
13268,18,433,3174.75,3,3,3,9,333
13269,1,315,5343.28,3,3,3,9,333
13270,366,1,590,1,1,2,4,112
13271,37,87,211.49,2,3,1,6,231
13272,31,15,276.56,2,1,1,4,211
13273,113,16,138.98,1,1,1,3,111
13276,64,30,590.93,2,2,2,6,222
13277,16,8,258.4,3,1,1,5,311
13278,41,46,542.73,2,2,2,6,222
13279,78,9,137.75,2,1,1,4,211
13280,122,82,798.46,1,3,2,6,132
13282,18,37,1132.14,3,2,2,7,322
13283,60,7,93.66,2,1,1,4,211
13284,331,13,201.19,1,1,1,3,111
13285,23,187,2709.12,3,3,3,9,333
13291,156,42,361.11,1,2,1,4,121
13292,39,31,578.94,2,2,2,6,222
13294,190,54,873.74,1,2,2,5,122
13295,360,10,201.2,1,1,1,3,111
13296,137,5,87.4,1,1,1,3,111
13297,8,59,2089.85,3,2,3,8,323
13298,1,2,360,3,1,1,5,311
13299,268,5,142.5,1,1,1,3,111
13300,169,20,371.89,1,1,1,3,111
13301,104,81,618.09,1,3,2,6,132
13302,155,1,63.75,1,1,1,3,111
13304,351,21,300.42,1,1,1,3,111
13305,4,81,2000.86,3,3,3,9,333
13307,120,1,15,1,1,1,3,111
13308,23,54,1385.51,3,2,3,8,323
13309,7,107,1456.79,3,3,3,9,333
13310,28,72,1132.03,2,2,2,6,222
13311,4,26,598.57,3,2,2,7,322
13313,22,78,1555.32,3,3,3,9,333
13314,2,62,775.94,3,2,2,7,322
13316,37,86,5732.93,2,3,3,8,233
13317,66,124,2273.68,2,3,3,8,233
13318,1,20,640.76,3,1,2,6,312
13319,5,476,10845.55,3,3,3,9,333
13320,78,105,1532.2,2,3,3,8,233
13321,72,11,567.36,2,1,2,5,212
13322,17,25,199.48,3,2,1,6,321
13323,3,21,787.85,3,1,2,6,312
13324,36,75,7121.95,2,3,3,8,233
13325,82,12,675.3,2,1,2,5,212
13327,39,108,3627.77,2,3,3,8,233
13328,316,17,1308.48,1,1,3,5,113
13329,32,17,789,2,1,2,5,212
13330,93,53,1140.93,1,2,2,5,122
13332,14,21,350.9,3,1,1,5,311
13334,82,265,3502.32,2,3,3,8,233
13336,77,51,795.12,2,2,2,6,222
13338,158,19,487.02,1,1,2,4,112
13339,201,54,860.12,1,2,2,5,122
13340,45,134,10736.48,2,3,3,8,233
13341,261,42,775.85,1,2,2,5,122
13343,178,19,353.43,1,1,1,3,111
13344,68,116,2511.69,2,3,3,8,233
13345,288,20,389.5,1,1,2,4,112
13347,70,8,341.36,2,1,1,4,211
13348,64,14,233.76,2,1,1,4,211
13349,11,16,247.32,3,1,1,5,311
13350,16,40,979.12,3,2,2,7,322
13351,66,16,373.94,2,1,1,4,211
13352,60,24,397.98,2,2,2,6,222
13354,71,51,743.53,2,2,2,6,222
13355,122,32,674.7,1,2,2,5,122
13356,80,42,768.24,2,2,2,6,222
13357,257,89,609.4,1,3,2,6,132
13358,269,29,439.03,1,2,2,5,122
13359,64,23,439.56,2,1,2,5,212
13362,9,166,3090.74,3,3,3,9,333
13363,18,60,992.5,3,2,2,7,322
13364,71,10,134.96,2,1,1,4,211
13365,34,128,2225.37,2,3,3,8,233
13366,50,1,56.16,2,1,1,4,211
13368,257,29,623.4,1,2,2,5,122
13369,366,14,308.28,1,1,1,3,111
13370,372,39,754.87,1,2,2,5,122
13372,90,23,378.64,2,1,1,4,211
13373,61,158,3312.25,2,3,3,8,233
13375,89,37,778.65,2,2,2,6,222
13376,99,53,1019.76,1,2,2,5,122
13379,26,97,572.56,2,3,2,7,232
13381,32,172,3639.31,2,3,3,8,233
13382,281,15,222.99,1,1,1,3,111
13384,31,152,4151.93,2,3,3,8,233
13385,330,35,534.57,1,2,2,5,122
13388,131,35,677.1,1,2,2,5,122
13389,11,51,797.96,3,2,2,7,322
13390,75,13,544.08,2,1,2,5,212
13391,204,1,59.8,1,1,1,3,111
13394,2,155,2520.02,3,3,3,9,333
13395,185,21,307.72,1,1,1,3,111
13396,29,43,1360.99,2,2,3,7,223
13397,73,38,1544.13,2,2,3,7,223
13398,192,26,457.34,1,2,2,5,122
13402,127,39,621.23,1,2,2,5,122
13403,18,3,75,3,1,1,5,311
13404,1,11,252.49,3,1,1,5,311
13405,74,27,572.451,2,2,2,6,222
13408,2,478,28117.04,3,3,3,9,333
13410,24,28,1003.06,3,2,2,7,322
13411,107,18,213.55,1,1,1,3,111
13414,134,24,1390.5,1,2,3,6,123
13416,44,19,712.5,2,1,2,5,212
13417,5,28,640.83,3,2,2,7,322
13418,12,304,6127.43,3,3,3,9,333
13419,64,16,221.06,2,1,1,4,211
13420,150,8,159.85,1,1,1,3,111
13421,40,102,1833.71,2,3,3,8,233
13422,64,127,2626.3,2,3,3,8,233
13425,108,78,1624.21,1,3,3,7,133
13426,1,157,3641.32,3,3,3,9,333
13427,19,29,582.6,3,2,2,7,322
13428,10,71,201.78,3,2,1,6,321
13429,11,67,1006.8,3,2,2,7,322
13430,19,49,679.45,3,2,2,7,322
13431,67,46,1269.1,2,2,3,7,223
13434,74,10,534.24,2,1,2,5,212
13435,5,101,3809.89,3,3,3,9,333
13436,2,12,196.89,3,1,1,5,311
13437,14,167,3408.06,3,3,3,9,333
13439,255,54,283.71,1,2,1,4,121
13441,92,13,296.64,1,1,1,3,111
13447,23,59,1129.14,3,2,2,7,322
13448,17,194,3534.69,3,3,3,9,333
13449,24,19,291.88,3,1,1,5,311
13450,27,71,2043.72,2,2,3,7,223
13451,26,433,2898.26,2,3,3,8,233
13452,259,2,590,1,1,2,4,112
13453,166,17,356.98,1,1,1,3,111
13455,25,46,1058.34,3,2,2,7,322
13456,18,63,1766.72,3,2,3,8,323
13458,7,382,9646.57,3,3,3,9,333
13460,29,17,183.44,2,1,1,4,211
13461,39,27,1445,2,2,3,7,223
13462,253,9,151.5,1,1,1,3,111
13464,58,41,674.68,2,2,2,6,222
13466,184,17,307.9,1,1,1,3,111
13467,11,98,1071.91,3,3,2,8,332
13468,2,302,5704.97,3,3,3,9,333
13470,99,10,165,1,1,1,3,111
13471,1,254,2501.84,3,3,3,9,333
13473,61,21,422.64,2,1,2,5,212
13474,236,62,226.84,1,2,1,4,121
13475,191,86,1431.78,1,3,3,7,133
13476,179,58,1238.47,1,2,3,6,123
13477,38,79,1454.58,2,3,3,8,233
13479,201,15,300.95,1,1,1,3,111
13481,46,109,1804.56,2,3,3,8,233
13482,232,11,184.64,1,1,1,3,111
13483,66,10,140.34,2,1,1,4,211
13484,241,8,313.8,1,1,1,3,111
13485,233,23,454.24,1,1,2,4,112
13486,78,69,1122.41,2,2,2,6,222
13487,58,34,575.4,2,2,2,6,222
13488,17,422,8968.31,3,3,3,9,333
13489,105,14,449.52,1,1,2,4,112
13491,52,86,1215.82,2,3,3,8,233
13492,136,50,1269.84,1,2,3,6,123
13493,275,8,618.63,1,1,2,4,112
13494,312,18,316.26,1,1,1,3,111
13495,8,48,2044.87,3,2,3,8,323
13496,11,35,653.33,3,2,2,7,322
13497,283,19,348.05,1,1,1,3,111
13499,18,42,1159.11,3,2,2,7,322
13500,23,65,1166.77,3,2,2,7,322
13501,288,52,1340.32,1,2,3,6,123
13502,17,18,292,3,1,1,5,311
13503,71,17,216.85,2,1,1,4,211
13504,64,22,295.93,2,1,1,4,211
13505,73,215,4393.63,2,3,3,8,233
13506,316,26,458.52,1,2,2,5,122
13507,3,162,2479.16,3,3,3,9,333
13508,244,12,110.97,1,1,1,3,111
13509,9,44,979.72,3,2,2,7,322
13510,1,115,1791.56,3,3,3,9,333
13512,261,15,251.21,1,1,1,3,111
13513,127,10,205.1,1,1,1,3,111
13514,74,4,152.2,2,1,1,4,211
13515,73,59,891.12,2,2,2,6,222
13516,21,44,1389.41,3,2,3,8,323
13517,60,141,2128.42,2,3,3,8,233
13518,86,36,627.16,2,2,2,6,222
13519,78,8,122.75,2,1,1,4,211
13520,59,93,3624.35,2,3,3,8,233
13521,1,418,1071.73,3,3,2,8,332
13522,30,5,125.8,2,1,1,4,211
13523,33,172,3964.88,2,3,3,8,233
13524,41,27,680.18,2,2,2,6,222
13525,15,6,628.78,3,1,2,6,312
13527,34,217,2242.36,2,3,3,8,233
13529,79,15,307.76,2,1,1,4,211
13531,205,22,483.8,1,1,2,4,112
13532,34,66,210.31,2,2,1,5,221
13533,183,75,269.09,1,3,1,5,131
13534,2,296,5870.08,3,3,3,9,333
13536,1,178,3444.39,3,3,3,9,333
13538,43,25,1280.85,2,2,3,7,223
13539,86,37,631.34,2,2,2,6,222
13544,40,78,276.06,2,3,1,6,231
13546,12,97,621.09,3,3,2,8,332
13548,96,123,678.16,1,3,2,6,132
13549,26,51,918.2,2,2,2,6,222
13551,319,4,91.8,1,1,1,3,111
13552,66,109,3740.07,2,3,3,8,233
13555,74,135,4098.88,2,3,3,8,233
13557,28,34,584.06,2,2,2,6,222
13558,6,169,594.52,3,3,2,8,332
13560,7,32,171.42,3,2,1,6,321
13561,216,14,141.86,1,1,1,3,111
13562,82,82,1799.33,2,3,3,8,233
13563,84,49,777.53,2,2,2,6,222
13564,144,81,1724.67,1,3,3,7,133
13565,19,38,240.22,3,2,1,6,321
13566,41,169,856.84,2,3,2,7,232
13568,173,43,187.05,1,2,1,4,121
13569,17,79,338.62,3,3,1,7,331
13570,243,27,239.49,1,2,1,4,121
13571,13,340,2088.94,3,3,3,9,333
13572,206,33,1384.25,1,2,3,6,123
13573,50,25,290.25,2,2,1,5,221
13575,23,46,732.07,3,2,2,7,322
13576,10,126,6717.34,3,3,3,9,333
13577,25,83,1687.6,3,3,3,9,333
13579,15,23,467.04,3,1,2,6,312
13581,309,10,118,1,1,1,3,111
13583,156,53,781.03,1,2,2,5,122
13584,307,24,142.4,1,2,1,4,121
13587,64,8,712.4,2,1,2,5,212
13588,16,174,2478.95,3,3,3,9,333
13589,15,21,379.65,3,1,1,5,311
13590,11,87,1981.92,3,3,3,9,333
13591,65,58,1117.13,2,2,2,6,222
13592,36,16,247.96,2,1,1,4,211
13593,108,127,2011.88,1,3,3,7,133
13594,53,26,396.97,2,2,2,6,222
13596,6,146,664.11,3,3,2,8,332
13598,47,35,160.04,2,2,1,5,221
13599,1,246,5149.92,3,3,3,9,333
13600,312,19,219.52,1,1,1,3,111
13601,45,99,693.32,2,3,2,7,232
13602,65,23,428.89,2,1,2,5,212
13603,26,27,164.34,2,2,1,5,221
13606,29,40,276.75,2,2,1,5,221
13607,40,97,675.51,2,3,2,7,232
13610,12,215,1082.33,3,3,2,8,332
13611,89,72,1154.4,2,2,2,6,222
13614,24,195,1585.46,3,3,3,9,333
13615,319,23,417.69,1,1,2,4,112
13617,40,44,544.18,2,2,2,6,222
13618,174,13,177.34,1,1,1,3,111
13621,117,19,213.85,1,1,1,3,111
13623,31,78,727.74,2,3,2,7,232
13626,253,19,257.23,1,1,1,3,111
13627,59,92,1638.47,2,3,3,8,233
13629,23,59,7792.36,3,2,3,8,323
13630,5,71,2031.78,3,2,3,8,323
13631,100,11,3070.42,1,1,3,5,113
13632,25,145,2118.93,3,3,3,9,333
13634,33,186,1547.36,2,3,3,8,233
13635,68,62,1071.03,2,2,2,6,222
13636,37,63,949.12,2,2,2,6,222
13637,52,99,804.3,2,3,2,7,232
13638,16,8,122.64,3,1,1,5,311
13639,74,40,1033.34,2,2,2,6,222
13642,216,57,312.28,1,2,1,4,121
13643,31,28,519.44,2,2,2,6,222
13644,16,146,2624.26,3,3,3,9,333
13645,120,5,252.1,1,1,1,3,111
13647,10,78,1648.12,3,3,3,9,333
13649,257,23,346.6,1,1,1,3,111
13650,17,96,1836.34,3,3,3,9,333
13651,35,6,94.2,2,1,1,4,211
13652,46,63,1095.08,2,2,2,6,222
13654,43,166,2707.33,2,3,3,8,233
13655,114,56,932.97,1,2,2,5,122
13656,165,49,379.65,1,2,1,4,121
13657,11,16,382.14,3,1,1,5,311
13658,10,108,2639.17,3,3,3,9,333
13659,206,103,1563,1,3,3,7,133
13662,86,52,881.26,2,2,2,6,222
13663,179,13,189.47,1,1,1,3,111
13666,60,12,84.65,2,1,1,4,211
13667,149,83,299.05,1,3,1,5,131
13668,3,463,6309.83,3,3,3,9,333
13669,51,9,218.55,2,1,1,4,211
13670,75,25,349.7,2,2,1,5,221
13672,301,6,186.39,1,1,1,3,111
13673,19,60,387.44,3,2,1,6,321
13675,151,25,486.82,1,2,2,5,122
13678,152,16,232.6,1,1,1,3,111
13680,1,194,3719.12,3,3,3,9,333
13681,18,57,827.83,3,2,2,7,322
13682,187,3,59.5,1,1,1,3,111
13684,286,29,65.13,1,2,1,4,121
13685,3,39,3119.44,3,2,3,8,323
13686,183,8,72,1,1,1,3,111
13689,63,6,910,2,1,2,5,212
13690,59,9,172.25,2,1,1,4,211
13692,25,53,1488.32,3,2,3,8,323
13694,4,568,65039.62,3,3,3,9,333
13695,31,90,2504.13,2,3,3,8,233
13697,39,12,151.3,2,1,1,4,211
13699,155,14,308.58,1,1,1,3,111
13700,26,194,2248.63,2,3,3,8,233
13703,318,1,99.5,1,1,1,3,111
13704,5,134,2308.06,3,3,3,9,333
13705,8,28,711.86,3,2,2,7,322
13706,303,20,330.79,1,1,1,3,111
13707,267,48,806.41,1,2,2,5,122
13708,271,49,285.33,1,2,1,4,121
13709,4,335,6307.65,3,3,3,9,333
13710,32,8,180.48,2,1,1,4,211
13711,219,13,252.06,1,1,1,3,111
13712,247,10,228.84,1,1,1,3,111
13715,281,104,1077.39,1,3,2,6,132
13716,269,21,138.28,1,1,1,3,111
13717,32,102,1445.01,2,3,3,8,233
13718,246,12,306.55,1,1,1,3,111
13719,15,60,1041.68,3,2,2,7,322
13720,117,43,799.9,1,2,2,5,122
13721,36,28,524.14,2,2,2,6,222
13722,132,85,2375.41,1,3,3,7,133
13723,217,6,199.85,1,1,1,3,111
13725,50,104,1980.56,2,3,3,8,233
13726,39,42,1079.66,2,2,2,6,222
13727,29,20,333.48,2,1,1,4,211
13728,37,63,1016.14,2,2,2,6,222
13730,136,43,752.6,1,2,2,5,122
13731,219,38,610.59,1,2,2,5,122
13732,28,33,491.86,2,2,2,6,222
13735,25,195,2883.54,3,3,3,9,333
13736,5,190,729.8,3,3,2,8,332
13737,200,30,339.6,1,2,1,4,121
13739,18,3,216.9,3,1,1,5,311
13740,241,23,350.75,1,1,1,3,111
13741,72,34,668.43,2,2,2,6,222
13742,17,313,3107.87,3,3,3,9,333
13743,3,41,1341.6,3,2,3,8,323
13744,95,63,1080.52,1,2,2,5,122
13745,162,25,300.04,1,2,1,4,121
13747,374,1,79.6,1,1,1,3,111
13748,96,28,948.25,1,2,2,5,122
13750,54,24,1647.26,2,2,3,7,223
13751,288,9,296.25,1,1,1,3,111
13752,124,75,1175.38,1,3,2,6,132
13753,288,35,741.26,1,2,2,5,122
13754,152,12,282.6,1,1,1,3,111
13755,4,321,2108.06,3,3,3,9,333
13756,2,142,5189.52,3,3,3,9,333
13758,12,117,3190.55,3,3,3,9,333
13759,33,25,659.41,2,2,2,6,222
13760,54,57,286.79,2,2,1,5,221
13761,50,70,1070.65,2,2,2,6,222
13762,219,7,306.72,1,1,1,3,111
13763,63,15,1714.96,2,1,3,6,213
13764,71,207,1519.42,2,3,3,8,233
13767,2,368,17220.36,3,3,3,9,333
13769,2,135,2796.51,3,3,3,9,333
13771,64,119,2634.45,2,3,3,8,233
13772,34,173,1122.63,2,3,2,7,232
13774,82,22,345,2,1,1,4,211
13777,1,197,25977.16,3,3,3,9,333
13778,103,9,178.7,1,1,1,3,111
13780,7,57,360.01,3,2,1,6,321
13781,251,17,127.84,1,1,1,3,111
13782,13,113,908.86,3,3,2,8,332
13784,10,31,2462.79,3,2,3,8,323
13786,367,7,230.4,1,1,1,3,111
13787,76,31,309.04,2,2,1,5,221
13790,4,45,348.8,3,2,1,6,321
13791,128,11,1516,1,1,3,5,113
13792,66,13,195.55,2,1,1,4,211
13798,1,349,37153.85,3,3,3,9,333
13799,117,39,688.86,1,2,2,5,122
13800,310,33,558.32,1,2,2,5,122
13801,67,23,324.8,2,1,1,4,211
13802,139,60,4599.42,1,2,3,6,123
13803,255,17,277.07,1,1,1,3,111
13804,31,135,2588.39,2,3,3,8,233
13805,52,13,924.6,2,1,2,5,212
13806,64,10,256.38,2,1,1,4,211
13807,367,7,112.6,1,1,1,3,111
13808,6,76,1747.66,3,3,3,9,333
13809,305,12,155.05,1,1,1,3,111
13810,29,35,1499.01,2,2,3,7,223
13811,184,13,814.5,1,1,2,4,112
13812,42,36,539,2,2,2,6,222
13813,40,69,1366.86,2,2,3,7,223
13814,92,57,1579.12,1,2,3,6,123
13815,22,176,4027.36,3,3,3,9,333
13816,24,28,571.67,3,2,2,7,322
13817,29,24,382.98,2,2,1,5,221
13819,302,36,1140.35,1,2,2,5,122
13821,145,59,385.64,1,2,1,4,121
13822,6,96,632,3,3,2,8,332
13823,19,40,957.66,3,2,2,7,322
13824,33,46,1698.94,2,2,3,7,223
13826,176,10,189.5,1,1,1,3,111
13827,58,92,409.8,2,3,2,7,232
13828,22,15,209.49,3,1,1,5,311
13831,16,72,2198.45,3,2,3,8,323
13832,19,3,52.2,3,1,1,5,311
13833,159,28,383.85,1,2,1,4,121
13835,25,55,834.57,3,2,2,7,322
13837,212,18,266.59,1,1,1,3,111
13838,6,165,674.82,3,3,2,8,332
13841,253,1,85,1,1,1,3,111
13842,59,206,3385.62,2,3,3,8,233
13844,11,20,361.62,3,1,1,5,311
13845,65,9,312.98,2,1,1,4,211
13846,25,55,865.06,3,2,2,7,322
13848,92,5,1255,1,1,3,5,113
13849,52,101,1537.95,2,3,3,8,233
13850,129,93,1595.48,1,3,3,7,133
13851,96,81,2651.46,1,3,3,7,133
13853,57,23,1090.14,2,1,2,5,212
13854,9,110,8109.52,3,3,3,9,333
13856,169,14,388.5,1,1,2,4,112
13858,57,11,216.17,2,1,1,4,211
13859,326,28,201.16,1,2,1,4,121
13860,1,76,1245.9,3,3,3,9,333
13862,18,139,2209.36,3,3,3,9,333
13863,248,20,305.78,1,1,1,3,111
13865,58,30,501.56,2,2,2,6,222
13866,74,7,145.67,2,1,1,4,211
13867,31,60,1005.09,2,2,2,6,222
13868,7,33,3192.54,3,2,3,8,323
13869,123,304,3083.65,1,3,3,7,133
13870,2,115,2770.94,3,3,3,9,333
13871,23,336,6403.25,3,3,3,9,333
13873,120,23,389.6,1,1,2,4,112
13874,358,18,540.45,1,1,2,4,112
13875,54,104,1786.79,2,3,3,8,233
13876,64,7,122.7,2,1,1,4,211
13877,86,3,117.24,2,1,1,4,211
13878,55,35,1271.57,2,2,3,7,223
13880,21,165,3219.77,3,3,3,9,333
13881,4,178,17159.52,3,3,3,9,333
13882,3,65,1191.13,3,2,2,7,322
13883,11,142,2674.48,3,3,3,9,333
13884,7,59,787.6,3,2,2,7,322
13885,189,28,506.8,1,2,2,5,122
13886,71,16,243.56,2,1,1,4,211
13887,204,19,349.55,1,1,1,3,111
13888,120,39,595.67,1,2,2,5,122
13889,93,15,416.9,1,1,2,4,112
13890,1,110,1883.81,3,3,3,9,333
13892,27,27,632.97,2,2,2,6,222
13893,298,21,821.1,1,1,2,4,112
13894,24,27,564.62,3,2,2,7,322
13895,28,118,2593.07,2,3,3,8,233
13897,50,17,311.16,2,1,1,4,211
13898,326,12,155.93,1,1,1,3,111
13899,16,19,388.52,3,1,2,6,312
13900,183,43,740.95,1,2,2,5,122
13901,72,149,2867.2,2,3,3,8,233
13904,37,26,332.64,2,2,1,5,221
13908,80,122,2369.55,2,3,3,8,233
13911,57,148,2580.91,2,3,3,8,233
13914,12,33,626.45,3,2,2,7,322
13917,50,18,272.04,2,1,1,4,211
13918,50,30,1212.84,2,2,3,7,223
13919,59,28,384.81,2,2,1,5,221
13922,352,7,172.25,1,1,1,3,111
13923,54,20,351.13,2,1,1,4,211
13924,2,117,1838.85,3,3,3,9,333
13925,93,41,678.25,1,2,2,5,122
13926,23,11,223.85,3,1,1,5,311
13927,75,21,348.99,2,1,1,4,211
13928,11,27,464.57,3,2,2,7,322
13929,169,9,842.65,1,1,2,4,112
13930,58,17,337.34,2,1,1,4,211
13931,96,58,1237.53,1,2,3,6,123
13932,295,16,307.4,1,1,1,3,111
13933,109,23,608.79,1,1,2,4,112
13934,264,31,922.1,1,2,2,5,122
13936,180,26,376.58,1,2,1,4,121
13937,169,9,158.85,1,1,1,3,111
13938,35,7,71.66,2,1,1,4,211
13939,23,45,568.55,3,2,2,7,322
13940,17,49,839.14,3,2,2,7,322
13941,22,45,5112.96,3,2,3,8,323
13946,79,11,561.57,2,1,2,5,212
13947,65,5,90.6,2,1,1,4,211
13948,361,3,102,1,1,1,3,111
13949,3,160,2427.32,3,3,3,9,333
13950,11,35,745.06,3,2,2,7,322
13951,176,39,674.45,1,2,2,5,122
13952,218,137,3251.071,1,3,3,7,133
13953,7,20,3515.68,3,1,3,7,313
13954,2,25,439.92,3,2,2,7,322
13955,154,33,322.96,1,2,1,4,121
13956,5,147,1019.27,3,3,2,8,332
13959,79,90,594.04,2,3,2,7,232
13960,21,12,230.22,3,1,1,5,311
13962,22,11,169.55,3,1,1,5,311
13963,308,35,664.54,1,2,2,5,122
13967,146,2,80.7,1,1,1,3,111
13969,7,619,9024.17,3,3,3,9,333
13971,19,149,2758.26,3,3,3,9,333
13972,71,15,190.25,2,1,1,4,211
13973,287,11,264.7,1,1,1,3,111
13974,49,28,413.59,2,2,2,6,222
13975,31,329,2461.24,2,3,3,8,233
13976,207,10,357.98,1,1,1,3,111
13978,15,15,196.79,3,1,1,5,311
13979,73,54,869.87,2,2,2,6,222
13980,60,11,200.14,2,1,1,4,211
13982,39,111,1871.81,2,3,3,8,233
13983,30,107,2603.43,2,3,3,8,233
13984,27,16,920.51,2,1,2,5,212
13985,4,349,7060.13,3,3,3,9,333
13986,17,13,320.46,3,1,1,5,311
13988,20,234,4147.96,3,3,3,9,333
13989,66,41,1266.08,2,2,3,7,223
13990,213,16,311.3,1,1,1,3,111
13991,12,82,852.88,3,3,2,8,332
13992,30,5,76.8,2,1,1,4,211
13993,43,121,3466.36,2,3,3,8,233
13994,4,148,2274.14,3,3,3,9,333
13995,15,86,1393.69,3,3,3,9,333
13999,10,208,3901.81,3,3,3,9,333
14000,211,15,635.66,1,1,2,4,112
14001,46,39,2043.08,2,2,3,7,223
14002,134,47,529.73,1,2,2,5,122
14004,43,171,4582.64,2,3,3,8,233
14005,10,84,2874.72,3,3,3,9,333
14006,116,30,962.19,1,2,2,5,122
14009,198,42,695.61,1,2,2,5,122
14012,278,11,328.8,1,1,1,3,111
14013,110,34,473.02,1,2,2,5,122
14014,77,39,505.18,2,2,2,6,222
14015,53,20,917.34,2,1,2,5,212
14016,162,161,4341.21,1,3,3,7,133
14019,47,66,1421.61,2,2,3,7,223
14020,17,39,642.8,3,2,2,7,322
14021,155,22,631.9,1,1,2,4,112
14022,225,28,440,1,2,2,5,122
14023,7,31,584.07,3,2,2,7,322
14024,122,16,327.7,1,1,1,3,111
14027,61,6,104.82,2,1,1,4,211
14029,63,15,467.66,2,1,2,5,212
14030,18,242,2358.84,3,3,3,9,333
14031,7,250,17286.86,3,3,3,9,333
14032,2,143,2975.59,3,3,3,9,333
14034,22,86,648.89,3,3,2,8,332
14035,29,66,1428.02,2,2,3,7,223
14036,285,38,626.65,1,2,2,5,122
14037,176,28,147.2,1,2,1,4,121
14038,78,92,1560.38,2,3,3,8,233
14039,33,6,152.2,2,1,1,4,211
14040,41,229,3560.32,2,3,3,8,233
14041,266,21,141.41,1,1,1,3,111
14044,27,206,646.42,2,3,2,7,232
14045,109,6,1659.75,1,1,3,5,113
14046,284,14,154.99,1,1,1,3,111
14047,9,32,1308.61,3,2,3,8,323
14048,305,85,409.93,1,3,2,6,132
14049,17,478,5578.72,3,3,3,9,333
14050,32,54,746.36,2,2,2,6,222
14051,1,210,15610.39,3,3,3,9,333
14052,20,56,225.36,3,2,1,6,321
14053,124,4,260.25,1,1,1,3,111
14054,65,6,92.46,2,1,1,4,211
14055,106,10,725.64,1,1,2,4,112
14056,1,1088,8152.71,3,3,3,9,333
14057,24,283,6211.66,3,3,3,9,333
14059,267,8,183.6,1,1,1,3,111
14060,5,202,6140.42,3,3,3,9,333
14062,10,111,10464.85,3,3,3,9,333
14064,29,77,1334.34,2,3,3,8,233
14066,267,7,152.55,1,1,1,3,111
14067,64,52,374.7,2,2,1,5,221
14068,320,24,265.85,1,2,1,4,121
14071,4,323,1437.57,3,3,3,9,333
14073,32,13,151.04,2,1,1,4,211
14075,5,43,942.26,3,2,2,7,322
14076,129,44,118.67,1,2,1,4,121
14077,41,42,499.42,2,2,2,6,222
14078,102,65,1049.37,1,2,2,5,122
14079,125,12,375.1,1,1,1,3,111
14080,33,4,45.6,2,1,1,4,211
14081,302,150,921.62,1,3,2,6,132
14082,365,29,182.25,1,2,1,4,121
14083,4,177,1002.9,3,3,2,8,332
14085,2,448,4421.29,3,3,3,9,333
14087,3,68,191.47,3,2,1,6,321
14088,10,589,50491.81,3,3,3,9,333
14089,57,13,158.75,2,1,1,4,211
14090,325,1,76.32,1,1,1,3,111
14092,8,214,4076.91,3,3,3,9,333
14093,12,100,433.86,3,3,2,8,332
14096,4,5111,65164.79,3,3,3,9,333
14098,37,21,147.35,2,1,1,4,211
14099,16,250,3104.17,3,3,3,9,333
14100,138,25,191.95,1,2,1,4,121
14101,74,35,5976.79,2,2,3,7,223
14102,5,58,1105.88,3,2,2,7,322
14104,155,21,216.21,1,1,1,3,111
14105,239,74,1266.23,1,3,3,7,133
14107,52,123,2703.23,2,3,3,8,233
14108,31,34,597.91,2,2,2,6,222
14109,73,9,144.2,2,1,1,4,211
14110,4,155,5683.15,3,3,3,9,333
14111,14,10,692.85,3,1,2,6,312
14112,23,160,2915.15,3,3,3,9,333
14113,4,34,1840.42,3,2,3,8,323
14114,274,15,386.53,1,1,1,3,111
14116,20,72,1382.74,3,2,3,8,323
14117,144,3,90,1,1,1,3,111
14121,4,159,2780.15,3,3,3,9,333
14124,84,5,419.58,2,1,2,5,212
14125,11,166,2720.63,3,3,3,9,333
14126,8,15,706.13,3,1,2,6,312
14127,123,44,709.71,1,2,2,5,122
14128,61,46,637.5,2,2,2,6,222
14129,2,52,1123.86,3,2,2,7,322
14130,319,66,480.91,1,2,2,5,122
14132,2,200,3586.03,3,3,3,9,333
14133,130,28,605.64,1,2,2,5,122
14135,2,134,4690.31,3,3,3,9,333
14138,2,46,965.88,3,2,2,7,322
14139,46,26,415.82,2,2,2,6,222
14140,4,66,935.05,3,2,2,7,322
14141,3,40,915.13,3,2,2,7,322
14142,373,22,311.81,1,1,1,3,111
14143,134,7,115.8,1,1,1,3,111
14145,47,11,3742.2,2,1,3,6,213
14146,9,210,4191,3,3,3,9,333
14147,78,5,483.4,2,1,2,5,212
14148,234,3,157.2,1,1,1,3,111
14149,221,28,446.62,1,2,2,5,122
14150,36,26,658.64,2,2,2,6,222
14152,75,49,621.29,2,2,2,6,222
14154,239,52,1345.62,1,2,3,6,123
14155,266,6,118.75,1,1,1,3,111
14156,10,1395,117210.08,3,3,3,9,333
14157,20,46,424.89,3,2,2,7,322
14158,40,41,507.66,2,2,2,6,222
14159,20,1175,4630.35,3,3,3,9,333
14161,216,104,1097.62,1,3,2,6,132
14162,174,25,289.36,1,2,1,4,121
14163,87,52,2445.91,2,2,3,7,223
14164,71,29,1631.77,2,2,3,7,223
14165,276,24,120.44,1,2,1,4,121
14167,39,50,562.59,2,2,2,6,222
14171,98,58,363.79,1,2,1,4,121
14173,11,29,450.84,3,2,2,7,322
14174,33,26,134.46,2,2,1,5,221
14175,60,149,3222.3,2,3,3,8,233
14176,297,31,576.9,1,2,2,5,122
14177,86,41,549.46,2,2,2,6,222
14178,9,318,1600.26,3,3,3,9,333
14179,41,157,701.57,2,3,2,7,232
14180,11,240,4748.52,3,3,3,9,333
14184,67,24,452.89,2,2,2,6,222
14185,331,3,197.65,1,1,1,3,111
14188,31,65,2054.36,2,2,3,7,223
14189,2,265,4654.08,3,3,3,9,333
14191,2,259,4684.76,3,3,3,9,333
14193,68,42,853.39,2,2,2,6,222
14194,5,579,11349.52,3,3,3,9,333
14195,202,7,1012,1,1,2,4,112
14196,107,6,335.52,1,1,1,3,111
14198,18,39,701.4,3,2,2,7,322
14199,218,2,185.4,1,1,1,3,111
14201,60,37,747.44,2,2,2,6,222
14204,2,39,150.61,3,2,1,6,321
14205,17,24,466.7,3,2,2,7,322
14206,239,20,328.16,1,1,1,3,111
14208,95,10,151.74,1,1,1,3,111
14209,11,87,2073.43,3,3,3,9,333
14210,106,102,1905.84,1,3,3,7,133
14211,53,112,2241.1,2,3,3,8,233
14212,90,9,1070.48,2,1,2,5,212
14214,31,67,1004.38,2,2,2,6,222
14215,12,108,1789.72,3,3,3,9,333
14216,3,59,1839.3,3,2,3,8,323
14217,2,100,2004.98,3,3,3,9,333
14218,43,12,169.48,2,1,1,4,211
14219,4,7,89.94,3,1,1,5,311
14220,247,21,632.4,1,1,2,4,112
14221,42,193,3432.8,2,3,3,8,233
14222,177,41,683.17,1,2,2,5,122
14223,92,60,991.13,1,2,2,5,122
14224,110,113,1009.73,1,3,2,6,132
14226,29,66,2214.79,2,2,3,7,223
14227,26,175,3350.96,2,3,3,8,233
14229,52,40,1547.2,2,2,3,7,223
14231,184,50,925.71,1,2,2,5,122
14232,43,115,2048.07,2,3,3,8,233
14233,49,35,1462.72,2,2,3,7,223
14234,22,147,754.12,3,3,2,8,332
14235,75,79,3144.86,2,3,3,8,233
14236,81,15,490.86,2,1,2,5,212
14237,373,9,161,1,1,1,3,111
14238,326,8,146.85,1,1,1,3,111
14239,43,112,2380.85,2,3,3,8,233
14240,30,42,890.34,2,2,2,6,222
14241,184,10,213.7,1,1,1,3,111
14242,235,16,280.55,1,1,1,3,111
14243,9,141,2588.77,3,3,3,9,333
14245,220,108,1693.45,1,3,3,7,133
14246,111,75,1474.06,1,3,3,7,133
14247,278,20,136.77,1,1,1,3,111
14248,318,8,302.58,1,1,1,3,111
14250,7,111,1904.05,3,3,3,9,333
14251,2,78,2879.7,3,3,3,9,333
14256,260,53,969.06,1,2,2,5,122
14257,64,106,3099.72,2,3,3,8,233
14258,9,111,12669.98,3,3,3,9,333
14259,142,5,120,1,1,1,3,111
14261,51,52,1163.45,2,2,2,6,222
14262,8,143,2618.23,3,3,3,9,333
14264,155,17,333.97,1,1,1,3,111
14265,109,31,530.18,1,2,2,5,122
14267,163,55,1516.24,1,2,3,6,123
14270,332,29,492.65,1,2,2,5,122
14271,226,10,112.32,1,1,1,3,111
14272,74,33,437.96,2,2,2,6,222
14273,51,29,559.97,2,2,2,6,222
14276,99,64,1119.74,1,2,2,5,122
14277,15,222,4188,3,3,3,9,333
14280,197,8,134.04,1,1,1,3,111
14282,3,154,3701.44,3,3,3,9,333
14284,31,32,595.25,2,2,2,6,222
14285,21,27,1910.01,3,2,3,8,323
14286,24,280,4628.75,3,3,3,9,333
14287,8,9,176.63,3,1,1,5,311
14288,213,16,426.6,1,1,2,4,112
14289,9,47,911.26,3,2,2,7,322
14290,11,101,2314.65,3,3,3,9,333
14291,2,237,3883.25,3,3,3,9,333
14292,8,100,4871.93,3,3,3,9,333
14293,3,61,1046.56,3,2,2,7,322
14295,40,5,166.2,2,1,1,4,211
14297,18,62,1305.33,3,2,3,8,323
14298,8,1637,51527.3,3,3,3,9,333
14299,8,143,3965.62,3,3,3,9,333
14300,19,3,43.2,3,1,1,5,311
14301,117,13,640.14,1,1,2,4,112
14304,223,17,383.45,1,1,1,3,111
14305,71,105,1858.96,2,3,3,8,233
14306,51,33,2093.32,2,2,3,7,223
14307,89,180,2995.72,2,3,3,8,233
14309,8,117,2352.53,3,3,3,9,333
14311,243,20,310.26,1,1,1,3,111
14312,47,87,1611.59,2,3,3,8,233
14314,107,8,120,1,1,1,3,111
14315,45,101,2481.13,2,3,3,8,233
14317,65,24,508.58,2,2,2,6,222
14320,207,31,477.79,1,2,2,5,122
14321,11,123,1530.75,3,3,3,9,333
14323,115,36,605.06,1,2,2,5,122
14326,242,8,183.85,1,1,1,3,111
14327,163,12,311.65,1,1,1,3,111
14329,17,258,4975.24,3,3,3,9,333
14331,124,28,462.66,1,2,2,5,122
14332,23,25,840.21,3,2,2,7,322
14333,68,15,415.2,2,1,2,5,212
14334,17,162,2552.21,3,3,3,9,333
14335,16,60,454.86,3,2,2,7,322
14336,17,90,1614.91,3,3,3,9,333
14338,161,31,588.22,1,2,2,5,122
14339,243,14,309.52,1,1,1,3,111
14340,219,6,134.7,1,1,1,3,111
14341,45,128,2166.98,2,3,3,8,233
14342,21,21,668.56,3,1,2,6,312
14344,127,71,889.93,1,2,2,5,122
14345,39,6,108.98,2,1,1,4,211
14346,121,60,1021.58,1,2,2,5,122
14348,260,18,409.57,1,1,2,4,112
14349,10,31,133.5,3,2,1,6,321
14350,274,18,282.93,1,1,1,3,111
14351,165,1,51,1,1,1,3,111
14352,157,47,1078.96,1,2,2,5,122
14353,215,6,90.6,1,1,1,3,111
14354,6,9,163.62,3,1,1,5,311
14355,366,11,174.4,1,1,1,3,111
14356,80,33,701.23,2,2,2,6,222
14357,43,40,225.12,2,2,1,5,221
14359,19,55,912.18,3,2,2,7,322
14360,32,117,2118.03,2,3,3,8,233
14362,22,37,151.5,3,2,1,6,321
14364,109,69,3717.35,1,2,3,6,123
14367,8,521,9227.82,3,3,3,9,333
14368,320,8,155,1,1,1,3,111
14371,295,4,100.5,1,1,1,3,111
14373,358,4,76.55,1,1,1,3,111
14375,185,66,235.56,1,2,1,4,121
14377,191,11,617.05,1,1,2,4,112
14379,44,46,348.1,2,2,1,5,221
14381,52,56,202.68,2,2,1,5,221
14382,26,126,615.49,2,3,2,7,232
14383,38,59,1247.69,2,2,3,7,223
14385,9,14,202.11,3,1,1,5,311
14386,297,7,142.4,1,1,1,3,111
14387,33,139,1727.6,2,3,3,8,233
14388,10,186,3212.84,3,3,3,9,333
14389,65,45,1043.46,2,2,2,6,222
14390,10,284,4642.57,3,3,3,9,333
14393,218,5,67.95,1,1,1,3,111
14395,2,348,3479.91,3,3,3,9,333
14396,65,73,487.99,2,3,2,7,232
14397,3,87,2612.96,3,3,3,9,333
14400,149,25,574.7,1,2,2,5,122
14401,4,182,4051.48,3,3,3,9,333
14403,130,20,1475.81,1,1,3,5,113
14404,34,100,1449.32,2,3,3,8,233
14406,119,8,156.75,1,1,1,3,111
14407,107,73,2157.73,1,3,3,7,133
14408,11,106,2599.03,3,3,3,9,333
14409,71,54,2059.45,2,2,3,7,223
14410,92,189,1100.27,1,3,2,6,132
14411,311,14,1063,1,1,2,4,112
14412,43,43,770.03,2,2,2,6,222
14413,362,22,121.05,1,1,1,3,111
14414,92,97,1496.98,1,3,3,7,133
14415,1,579,5855.57,3,3,3,9,333
14416,22,14,490.22,3,1,2,6,312
14418,4,124,1937.25,3,3,3,9,333
14419,11,202,1051.79,3,3,2,8,332
14420,99,29,387.52,1,2,1,4,121
14421,57,27,813.11,2,2,2,6,222
14422,1,222,4263.64,3,3,3,9,333
14423,218,3,265.2,1,1,1,3,111
14424,18,1,322.08,3,1,1,5,311
14426,24,224,4481.67,3,3,3,9,333
14427,50,17,363.34,2,1,1,4,211
14428,7,137,1224.06,3,3,3,9,333
14431,303,17,470.36,1,1,2,4,112
14432,10,377,2248.5,3,3,3,9,333
14434,22,12,1372.8,3,1,3,7,313
14436,99,9,89.06,1,1,1,3,111
14437,366,5,63,1,1,1,3,111
14438,306,9,131.9,1,1,1,3,111
14439,320,32,2661.24,1,2,3,6,123
14440,8,55,2357.68,3,2,3,8,323
14441,1,51,1712.89,3,2,3,8,323
14442,205,63,1589.82,1,2,3,6,123
14443,54,93,1420.2,2,3,3,8,233
14446,1,277,1010.35,3,3,2,8,332
14447,19,70,1163.23,3,2,2,7,322
14448,9,20,375.35,3,1,1,5,311
14449,19,250,885.8,3,3,2,8,332
14450,181,40,483.25,1,2,2,5,122
14451,60,105,643.9,2,3,2,7,232
14452,11,60,259.05,3,2,1,6,321
14453,190,22,119.93,1,1,1,3,111
14456,5,947,3017.28,3,3,3,9,333
14457,311,4,113.64,1,1,1,3,111
14459,155,37,1837.92,1,2,3,6,123
14460,110,16,434.34,1,1,2,4,112
14461,148,180,2103.06,1,3,3,7,133
14462,66,233,1980.57,2,3,3,8,233
14463,98,6,529.62,1,1,2,4,112
14465,247,123,1038.44,1,3,2,6,132
14466,29,72,2272.4,2,2,3,7,223
14467,18,89,596.26,3,3,2,8,332
14470,12,43,461.19,3,2,2,7,322
14472,104,265,1852.67,1,3,3,7,133
14473,74,7,234.34,2,1,1,4,211
14474,46,29,547.66,2,2,2,6,222
14475,72,42,925.85,2,2,2,6,222
14476,257,17,193,1,1,1,3,111
14477,20,10,1309.6,3,1,3,7,313
14479,254,18,316.25,1,1,1,3,111
14480,11,13,279.05,3,1,1,5,311
14481,165,30,636.51,1,2,2,5,122
14482,18,137,2022.81,3,3,3,9,333
14483,282,9,137.1,1,1,1,3,111
14484,50,14,321.92,2,1,1,4,211
14485,39,46,162.8,2,2,1,5,221
14487,27,140,1165.48,2,3,2,7,232
14488,68,46,1064.28,2,2,2,6,222
14489,207,30,463.38,1,2,2,5,122
14491,175,17,340.93,1,1,1,3,111
14493,7,120,2383.24,3,3,3,9,333
14494,26,7,139.56,2,1,1,4,211
14495,51,6,123.8,2,1,1,4,211
14496,312,19,538.81,1,1,2,4,112
14497,309,29,475.37,1,2,2,5,122
14498,43,193,1957.32,2,3,3,8,233
14499,26,190,808.44,2,3,2,7,232
14500,88,7,356.85,2,1,1,4,211
14501,184,10,251.21,1,1,1,3,111
14502,20,608,2429.83,3,3,3,9,333
14503,3,164,3543.26,3,3,3,9,333
14504,47,107,673.26,2,3,2,7,232
14505,17,785,5859.43,3,3,3,9,333
14506,17,295,1960.65,3,3,3,9,333
14507,24,95,1367.88,3,3,3,9,333
14508,22,55,268.05,3,2,1,6,321
14511,11,68,1314.81,3,2,3,8,323
14512,188,23,275.28,1,1,1,3,111
14513,101,12,455.59,1,1,2,4,112
14514,61,69,990.2,2,2,2,6,222
14515,18,98,2076.89,3,3,3,9,333
14517,33,18,330.45,2,1,1,4,211
14518,64,16,174.37,2,1,1,4,211
14520,2,4,270.6,3,1,1,5,311
14522,24,17,974.54,3,1,2,6,312
14523,108,12,241.09,1,1,1,3,111
14524,32,197,1843.83,2,3,3,8,233
14525,20,282,4215.9,3,3,3,9,333
14527,3,971,8507.13,3,3,3,9,333
14528,37,18,364.22,2,1,1,4,211
14529,60,213,578.61,2,3,2,7,232
14530,26,213,2862.11,2,3,3,8,233
14532,236,64,932.85,1,2,2,5,122
14533,25,62,1949.72,3,2,3,8,323
14534,3,508,4397.3,3,3,3,9,333
14535,60,328,2854.84,2,3,3,8,233
14536,260,18,170.95,1,1,1,3,111
14537,58,10,355.56,2,1,1,4,211
14538,65,19,388.25,2,1,2,5,212
14539,16,32,537.48,3,2,2,7,322
14540,10,71,952.66,3,2,2,7,322
14541,59,105,1453.35,2,3,3,8,233
14542,186,5,103.25,1,1,1,3,111
14543,29,71,3599.73,2,2,3,7,223
14544,24,111,2004.3,3,3,3,9,333
14546,5,397,2573.93,3,3,3,9,333
14547,4,355,3974.75,3,3,3,9,333
14548,151,4,652.8,1,1,2,4,112
14549,311,56,289.24,1,2,1,4,121
14550,11,47,757.37,3,2,2,7,322
14551,18,10,186.23,3,1,1,5,311
14552,152,57,164.22,1,2,1,4,121
14553,19,113,859.27,3,3,2,8,332
14554,10,203,2279.49,3,3,3,9,333
14555,57,19,312.54,2,1,1,4,211
14557,85,16,788.38,2,1,2,5,212
14560,7,74,2237.77,3,3,3,9,333
14561,76,69,1080.76,2,2,2,6,222
14562,4,419,5006.77,3,3,3,9,333
14565,96,127,3099.12,1,3,3,7,133
14566,111,4,1432,1,1,3,5,113
14567,57,33,1530.36,2,2,3,7,223
14569,1,12,227.39,3,1,1,5,311
14570,281,29,218.06,1,2,1,4,121
14572,3,262,2804.54,3,3,3,9,333
14573,180,227,1639.82,1,3,3,7,133
14576,372,1,35.4,1,1,1,3,111
14577,13,123,859.71,3,3,2,8,332
14578,3,24,168.63,3,2,1,6,321
14581,17,17,138.6,3,1,1,5,311
14582,41,6,114.11,2,1,1,4,211
14583,6,302,986.96,3,3,2,8,332
14584,169,98,1033.06,1,3,2,6,132
14585,50,29,157.05,2,2,1,5,221
14586,277,19,237.36,1,1,1,3,111
14587,19,371,1580.29,3,3,3,9,333
14589,372,3,39.75,1,1,1,3,111
14591,15,176,1320.21,3,3,3,9,333
14592,35,158,557.94,2,3,2,7,232
14593,22,151,617.15,3,3,2,8,332
14594,7,52,363.33,3,2,1,6,321
14595,20,102,1740.6,3,3,3,9,333
14597,11,47,866.24,3,2,2,7,322
14598,44,50,221.97,2,2,1,5,221
14600,306,25,393.33,1,2,2,5,122
14601,11,7,213.96,3,1,1,5,311
14603,275,2,660,1,1,2,4,112
14606,1,2677,12076.15,3,3,3,9,333
14607,16,81,16209.5,3,3,3,9,333
14608,4,20,1785.15,3,1,3,7,313
14609,72,4,601.56,2,1,2,5,212
14616,243,3,406.08,1,1,2,4,112
14618,9,16,553.44,3,1,2,6,312
14619,246,20,394.44,1,1,2,4,112
14620,206,26,412.78,1,2,2,5,122
14621,1,92,1788.36,3,3,3,9,333
14622,185,21,320.58,1,1,1,3,111
14623,32,133,886.7,2,3,2,7,232
14624,57,13,225.85,2,1,1,4,211
14625,196,53,899.63,1,2,2,5,122
14626,24,122,2791.27,3,3,3,9,333
14628,91,24,671.96,2,2,2,6,222
14629,4,150,955.26,3,3,2,8,332
14631,51,41,1006.98,2,2,2,6,222
14632,263,8,114.56,1,1,1,3,111
14633,266,20,344.9,1,1,1,3,111
14636,36,28,609.85,2,2,2,6,222
14638,51,16,443.6,2,1,2,5,212
14639,52,172,2984.49,2,3,3,8,233
14640,24,105,2107.38,3,3,3,9,333
14641,22,7,110.46,3,1,1,5,311
14642,59,2,96.12,2,1,1,4,211
14643,170,31,693.81,1,2,2,5,122
14644,68,26,830.76,2,2,2,6,222
14645,157,30,597.09,1,2,2,5,122
14646,2,2076,280206.02,3,3,3,9,333
14647,201,28,236.04,1,2,1,4,121
14649,5,186,1402.59,3,3,3,9,333
14651,67,101,653.75,2,3,2,7,232
14652,77,29,114.18,2,2,1,5,221
14653,1,234,1926.65,3,3,3,9,333
14655,8,49,1932.23,3,2,3,8,323
14656,169,80,291.05,1,3,1,5,131
14657,18,126,848.22,3,3,2,8,332
14658,5,29,247.15,3,2,1,6,321
14659,9,253,2529.93,3,3,3,9,333
14660,87,30,285.74,2,2,1,5,221
14661,27,4,107.95,2,1,1,4,211
14662,29,157,741.37,2,3,2,7,232
14664,20,98,636.24,3,3,2,8,332
14665,61,90,1835.7,2,3,3,8,233
14666,24,14,195.25,3,1,1,5,311
14667,11,567,9175.04,3,3,3,9,333
14669,242,166,1259.24,1,3,3,7,133
14670,280,123,392.86,1,3,2,6,132
14672,235,61,765.55,1,2,2,5,122
14673,3,74,1736.4,3,3,3,9,333
14675,16,97,596.36,3,3,2,8,332
14676,31,42,2548.24,2,2,3,7,223
14680,25,258,28754.11,3,3,3,9,333
14681,71,7,498.95,2,1,2,5,212
14682,188,2,52,1,1,1,3,111
14684,26,390,1201.51,2,3,3,8,233
14687,107,15,628.38,1,1,2,4,112
14688,8,324,5579.1,3,3,3,9,333
14689,209,13,112.8,1,1,1,3,111
14690,44,48,355.05,2,2,1,5,221
14691,31,71,2114.33,2,2,3,7,223
14692,137,68,591.55,1,2,2,5,122
14693,265,8,172.9,1,1,1,3,111
14696,4,130,2078.95,3,3,3,9,333
14697,218,22,188.61,1,1,1,3,111
14698,2,200,1217.27,3,3,3,9,333
14699,214,8,109.13,1,1,1,3,111
14700,32,112,2195.1,2,3,3,8,233
14701,11,327,2526.09,3,3,3,9,333
14702,1,342,3251.79,3,3,3,9,333
14703,15,22,318.17,3,1,1,5,311
14704,11,393,1493.96,3,3,3,9,333
14705,199,1,179,1,1,1,3,111
14708,3,28,1126.37,3,2,2,7,322
14709,15,196,4921.04,3,3,3,9,333
14710,14,136,599.48,3,3,2,8,332
14711,10,345,2839.62,3,3,3,9,333
14712,29,25,917.07,2,2,2,6,222
14713,9,338,2662.2,3,3,3,9,333
14714,24,10,160.19,3,1,1,5,311
14715,25,71,867.38,3,2,2,7,322
14716,43,51,307.51,2,2,1,5,221
14719,2,235,1581.84,3,3,3,9,333
14720,6,37,663.81,3,2,2,7,322
14722,147,28,180.42,1,2,1,4,121
14723,10,259,1122.36,3,3,2,8,332
14725,25,47,655.58,3,2,2,7,322
14727,274,10,268.58,1,1,1,3,111
14729,374,71,313.49,1,2,1,4,121
14730,1,462,1897.57,3,3,3,9,333
14731,47,45,380.02,2,2,1,5,221
14732,8,147,2702.49,3,3,3,9,333
14733,16,202,9585.91,3,3,3,9,333
14735,4,194,6065.69,3,3,3,9,333
14737,4,17,1164.55,3,1,2,6,312
14738,43,54,1314.45,2,2,3,7,223
14739,4,60,3902.28,3,2,3,8,323
14740,197,89,1448.21,1,3,3,7,133
14741,12,59,1400.34,3,2,3,8,323
14744,16,26,1099.98,3,2,2,7,322
14745,113,69,1220.26,1,2,3,6,123
14747,249,18,328.2,1,1,1,3,111
14748,29,89,1415.75,2,3,3,8,233
14752,44,5,389.64,2,1,2,5,212
14753,87,30,563.15,2,2,2,6,222
14754,45,41,638.05,2,2,2,6,222
14755,10,235,5010.28,3,3,3,9,333
14756,15,38,738.96,3,2,2,7,322
14757,75,19,420.5,2,1,2,5,212
14758,145,71,1484.06,1,2,3,6,123
14759,5,102,1625.97,3,3,3,9,333
14760,297,5,89.2,1,1,1,3,111
14761,59,11,255.9,2,1,1,4,211
14762,264,21,300.52,1,1,1,3,111
14764,47,6,278.3,2,1,1,4,211
14765,29,39,254.11,2,2,1,5,221
14766,8,135,2473.37,3,3,3,9,333
14768,17,5,192.6,3,1,1,5,311
14769,3,1062,10416.98,3,3,3,9,333
14770,232,52,876.42,1,2,2,5,122
14772,112,9,139.26,1,1,1,3,111
14775,58,60,1011.9,2,2,2,6,222
14776,51,117,2538.3,2,3,3,8,233
14778,127,35,730.86,1,2,2,5,122
14779,281,41,386.15,1,2,1,4,121
14780,55,27,447.68,2,2,2,6,222
14782,320,6,200.1,1,1,1,3,111
14784,26,15,289.99,2,1,1,4,211
14785,10,3,77.4,3,1,1,5,311
14788,7,30,679.44,3,2,2,7,322
14789,29,6,197.64,2,1,1,4,211
14790,17,46,745.06,3,2,2,7,322
14792,64,2,6.2,2,1,1,4,211
14793,21,14,228.99,3,1,1,5,311
14794,3,80,1319.91,3,3,3,9,333
14795,166,6,131.45,1,1,1,3,111
14796,1,1132,7975.49,3,3,3,9,333
14798,53,12,173.74,2,1,1,4,211
14799,51,13,157.7,2,1,1,4,211
14800,48,383,4331.79,2,3,3,8,233
14801,61,57,189.34,2,2,1,5,221
14803,162,44,845.55,1,2,2,5,122
14804,9,12,353.27,3,1,1,5,311
14805,15,46,546.4,3,2,2,7,322
14806,75,11,193.39,2,1,1,4,211
14808,40,231,2718.6,2,3,3,8,233
14810,41,254,2085.33,2,3,3,8,233
14813,370,29,152.88,1,2,1,4,121
14815,37,53,778.5,2,2,2,6,222
14816,197,4,271.85,1,1,1,3,111
14817,200,63,1110.34,1,2,2,5,122
14818,74,48,657.8,2,2,2,6,222
14819,64,13,272.07,2,1,1,4,211
14820,21,29,507.29,3,2,2,7,322
14821,367,2,48.8,1,1,1,3,111
14823,180,70,321.43,1,2,1,4,121
14824,10,29,1127.71,3,2,2,7,322
14825,4,120,2221.01,3,3,3,9,333
14828,197,17,2139.76,1,1,3,5,113
14829,29,42,697.55,2,2,2,6,222
14830,53,39,188.88,2,2,1,5,221
14834,18,67,1720.3,3,2,3,8,323
14836,10,6,102.45,3,1,1,5,311
14837,90,108,1649.5,2,3,3,8,233
14840,268,4,62.85,1,1,1,3,111
14841,53,138,3295.76,2,3,3,8,233
14842,44,145,2824.69,2,3,3,8,233
14844,64,130,3189.81,2,3,3,8,233
14847,149,13,309.4,1,1,1,3,111
14849,22,388,7930.54,3,3,3,9,333
14850,312,21,325.75,1,1,1,3,111
14851,23,28,511.35,3,2,2,7,322
14852,58,143,2836.69,2,3,3,8,233
14853,24,9,475.8,3,1,2,6,312
14854,78,126,2740.03,2,3,3,8,233
14855,119,20,645.65,1,1,2,4,112
14856,36,65,1290.53,2,2,3,7,223
14857,60,60,1173.12,2,2,2,6,222
14859,13,58,1353.74,3,2,3,8,323
14860,19,11,170.32,3,1,1,5,311
14861,52,6,125.79,2,1,1,4,211
14862,26,48,841.2,2,2,2,6,222
14863,29,11,266.76,2,1,1,4,211
14865,7,4,52.2,3,1,1,5,311
14866,11,99,14389.9,3,3,3,9,333
14867,186,36,710.28,1,2,2,5,122
14868,3,144,2953.59,3,3,3,9,333
14869,9,70,721.45,3,2,2,7,322
14870,262,13,327.25,1,1,1,3,111
14871,3,93,501.28,3,3,2,8,332
14873,210,28,519.68,1,2,2,5,122
14875,108,47,1465.32,1,2,3,6,123
14878,13,122,1476.09,3,3,3,9,333
14880,77,46,690.59,2,2,2,6,222
14881,20,17,255.4,3,1,1,5,311
14882,27,11,589.7,2,1,2,5,212
14883,19,53,761.59,3,2,2,7,322
14885,132,15,765.32,1,1,2,4,112
14886,253,18,364.8,1,1,1,3,111
14887,79,6,1862,2,1,3,6,213
14888,207,20,369.2,1,1,1,3,111
14889,336,10,135.9,1,1,1,3,111
14890,254,7,125.65,1,1,1,3,111
14891,148,33,554.38,1,2,2,5,122
14893,10,73,1237.85,3,3,3,9,333
14894,85,23,655.75,2,1,2,5,212
14895,8,498,11138.71,3,3,3,9,333
14896,205,43,468.77,1,2,2,5,122
14897,8,55,1366.38,3,2,3,8,323
14898,23,109,1269.31,3,3,3,9,333
14901,11,96,1421.29,3,3,3,9,333
14902,26,20,332.66,2,1,1,4,211
14903,21,350,2795.33,3,3,3,9,333
14904,2,69,1025.44,3,2,2,7,322
14905,158,17,616.15,1,1,2,4,112
14907,3,165,3501.1,3,3,3,9,333
14908,74,9,277.8,2,1,1,4,211
14910,3,30,434.35,3,2,2,7,322
14911,1,5670,143711.17,3,3,3,9,333
14912,17,27,867.85,3,2,2,7,322
14913,36,87,1227.43,2,3,3,8,233
14915,91,12,307.48,2,1,1,4,211
14916,71,77,1268.98,2,3,3,8,233
14918,116,45,1610.15,1,2,3,6,123
14920,213,57,977.77,1,2,2,5,122
14921,30,78,1316.07,2,3,3,8,233
14923,51,44,749.1,2,2,2,6,222
14924,246,10,310.05,1,1,1,3,111
14929,32,11,223.88,2,1,1,4,211
14930,109,127,2362.96,1,3,3,7,133
14931,5,41,1257.68,3,2,3,8,323
14932,366,17,363.53,1,1,1,3,111
14934,82,87,1890.94,2,3,3,8,233
14935,297,10,1784.71,1,1,3,5,113
14936,34,364,8137.02,2,3,3,8,233
14937,57,34,1621.88,2,2,3,7,223
14944,30,170,5900.25,2,3,3,8,233
14946,14,3,100.9,3,1,1,5,311
14947,72,14,290.82,2,1,1,4,211
14948,23,63,1101.97,3,2,2,7,322
14950,19,19,371.2,3,1,1,5,311
14951,79,20,311.69,2,1,1,4,211
14952,60,138,8099.49,2,3,3,8,233
14953,25,54,285.67,3,2,1,6,321
14954,12,77,294.85,3,3,1,7,331
14957,253,12,58.49,1,1,1,3,111
14958,147,41,483.73,1,2,2,5,122
14959,64,59,695.42,2,2,2,6,222
14960,8,27,221.27,3,2,1,6,321
14961,11,312,7044.68,3,3,3,9,333
14962,271,5,126.7,1,1,1,3,111
14963,10,192,1472.34,3,3,3,9,333
14964,247,13,206.21,1,1,1,3,111
14965,96,81,596.09,1,3,2,6,132
14966,15,36,183.02,3,2,1,6,321
14967,50,6,463.8,2,1,2,5,212
14968,30,37,147.59,2,2,1,5,221
14970,68,34,1592.06,2,2,3,7,223
14971,35,155,1097.98,2,3,2,7,232
14972,128,18,114.77,1,1,1,3,111
14973,107,32,1314.45,1,2,3,6,123
14974,37,17,89.94,2,1,1,4,211
14975,57,11,279.94,2,1,1,4,211
14976,57,72,790.86,2,2,2,6,222
14978,72,214,1921.37,2,3,3,8,233
14981,246,8,102.12,1,1,1,3,111
14984,19,39,202.37,3,2,1,6,321
14985,198,83,292.01,1,3,1,5,131
14987,16,4,326.4,3,1,1,5,311
14988,212,40,334.54,1,2,1,4,121
14995,39,60,231.98,2,2,1,5,221
14997,46,26,546.2,2,2,2,6,222
14998,170,74,414.87,1,3,2,6,132
15000,48,77,490.52,2,3,2,7,232
15002,116,115,1641.76,1,3,3,7,133
15004,147,154,1220.77,1,3,3,7,133
15005,16,1112,6295.37,3,3,3,9,333
15006,51,132,480.38,2,3,2,7,232
15007,159,12,156.91,1,1,1,3,111
15009,12,180,1259.43,3,3,3,9,333
15010,36,20,308.94,2,1,1,4,211
15012,54,122,405.04,2,3,2,7,232
15014,43,33,257.67,2,2,1,5,221
15016,173,20,170.04,1,1,1,3,111
15017,34,20,125.58,2,1,1,4,211
15018,39,31,496.21,2,2,2,6,222
15019,267,66,252.81,1,2,1,4,121
15021,9,444,1871.77,3,3,3,9,333
15022,12,121,852.39,3,3,2,8,332
15023,3,553,6720.41,3,3,3,9,333
15024,10,152,1636.43,3,3,3,9,333
15025,33,67,361.96,2,2,1,5,221
15026,80,61,469,2,2,2,6,222
15027,31,35,1066.15,2,2,2,6,222
15028,8,48,627.13,3,2,2,7,322
15030,72,7,518.28,2,1,2,5,212
15031,4,110,653.19,3,3,2,8,332
15032,256,52,4959.1,1,2,3,6,123
15033,5,501,2557.18,3,3,3,9,333
15034,16,390,4274.16,3,3,3,9,333
15035,90,27,252.73,2,2,1,5,221
15036,72,119,429.56,2,3,2,7,232
15038,59,125,685.74,2,3,2,7,232
15039,10,1477,19766.59,3,3,3,9,333
15041,170,66,179.93,1,2,1,4,121
15042,199,5,135.93,1,1,1,3,111
15043,31,3,537,2,1,2,5,212
15044,19,444,7634.73,3,3,3,9,333
15045,152,12,735.66,1,1,2,4,112
15046,9,201,5090.42,3,3,3,9,333
15047,270,22,343.62,1,1,1,3,111
15048,65,94,381,2,3,1,6,231
15049,274,3,121.17,1,1,1,3,111
15050,25,76,1737.69,3,3,3,9,333
15051,23,142,1383.36,3,3,3,9,333
15052,319,28,207.73,1,2,1,4,121
15053,5,69,693.95,3,2,2,7,322
15054,12,114,302.1,3,3,1,7,331
15057,275,25,1489.5,1,2,3,6,123
15058,25,266,2102.54,3,3,3,9,333
15059,41,237,1337.72,2,3,3,8,233
15060,8,115,294.25,3,3,1,7,331
15061,4,403,54534.14,3,3,3,9,333
15062,71,57,987.86,2,2,2,6,222
15063,213,5,370.8,1,1,1,3,111
15065,38,155,3158.13,2,3,3,8,233
15066,53,42,893.59,2,2,2,6,222
15067,78,82,1744.76,2,3,3,8,233
15068,46,104,553.36,2,3,2,7,232
15069,179,70,1109.53,1,2,2,5,122
15070,373,1,106.2,1,1,1,3,111
15071,94,26,982.07,1,2,2,5,122
15073,10,54,1043.41,3,2,2,7,322
15074,105,41,735.67,1,2,2,5,122
15075,78,27,773.03,2,2,2,6,222
15076,173,49,880.85,1,2,2,5,122
15078,7,440,9743.11,3,3,3,9,333
15079,213,47,895.61,1,2,2,5,122
15081,22,33,504.8,3,2,2,7,322
15083,257,5,88.2,1,1,1,3,111
15087,282,15,306.94,1,1,1,3,111
15088,21,57,1160.07,3,2,2,7,322
15089,10,145,2420.84,3,3,3,9,333
15090,308,23,381.32,1,1,1,3,111
15091,68,30,480.71,2,2,2,6,222
15092,215,26,457.81,1,2,2,5,122
15093,18,108,4597.02,3,3,3,9,333
15095,104,47,1370.6,1,2,3,6,123
15096,43,11,219.39,2,1,1,4,211
15097,4,25,248.08,3,2,1,6,321
15098,182,3,39916.5,1,1,3,5,113
15099,84,23,410.48,2,1,2,5,212
15100,334,3,876,1,1,2,4,112
15101,9,8,317.53,3,1,1,5,311
15103,31,35,703.36,2,2,2,6,222
15104,197,67,993.54,1,2,2,5,122
15105,18,101,2298.93,3,3,3,9,333
15106,18,100,1422.52,3,3,3,9,333
15107,311,16,319.5,1,1,1,3,111
15108,142,60,1300.25,1,2,3,6,123
15109,246,28,484.95,1,2,2,5,122
15110,24,35,996.1,3,2,2,7,322
15111,29,84,1567.48,2,3,3,8,233
15113,10,97,3509.43,3,3,3,9,333
15114,30,197,2760.56,2,3,3,8,233
15115,18,21,340.11,3,1,1,5,311
15116,18,45,1352.75,3,2,3,8,323
15117,15,79,1551.78,3,3,3,9,333
15118,134,1,244.8,1,1,1,3,111
15119,246,14,266.4,1,1,1,3,111
15120,134,21,358.82,1,1,1,3,111
15121,50,28,457.72,2,2,2,6,222
15122,114,82,1633.78,1,3,3,7,133
15123,7,106,2199.31,3,3,3,9,333
15124,23,15,184.19,3,1,1,5,311
15125,25,127,11528.48,3,3,3,9,333
15127,66,16,406.53,2,1,2,5,212
15128,60,102,1471,2,3,3,8,233
15129,50,84,3447.4,2,3,3,8,233
15130,170,22,330.11,1,1,1,3,111
15132,18,52,977.93,3,2,2,7,322
15133,128,29,982.42,1,2,2,5,122
15134,15,73,1387.99,3,3,3,9,333
15135,239,9,139.05,1,1,1,3,111
15136,3,68,1286.7,3,2,3,8,323
15139,240,13,178.96,1,1,1,3,111
15140,52,80,2354.25,2,3,3,8,233
15142,46,26,498.74,2,2,2,6,222
15143,226,14,259.45,1,1,1,3,111
15144,8,217,6580.44,3,3,3,9,333
15145,4,67,1194.73,3,2,3,8,323
15146,165,91,1327.16,1,3,3,7,133
15147,240,28,623.5,1,2,2,5,122
15148,11,20,301.29,3,1,1,5,311
15149,134,23,520.8,1,1,2,4,112
15150,17,341,5291.33,3,3,3,9,333
15152,10,271,4745.69,3,3,3,9,333
15153,31,22,329.25,2,1,1,4,211
15154,75,71,254.28,2,2,1,5,221
15156,1,55,961.49,3,2,2,7,322
15157,4,125,1936.07,3,3,3,9,333
15158,45,7,401.4,2,1,2,5,212
15159,2,710,18641.01,3,3,3,9,333
15160,357,4,158.16,1,1,1,3,111
15163,18,29,304.47,3,2,1,6,321
15164,69,101,824.58,2,3,2,7,232
15165,373,27,487.75,1,2,2,5,122
15167,321,39,158.8,1,2,1,4,121
15168,26,5,106.56,2,1,1,4,211
15171,331,5,1289.5,1,1,3,5,113
15172,9,110,1624.05,3,3,3,9,333
15174,323,11,135.75,1,1,1,3,111
15175,72,23,224.14,2,1,1,4,211
15178,260,3,40.5,1,1,1,3,111
15179,18,93,2206.95,3,3,3,9,333
15180,367,6,87.5,1,1,1,3,111
15181,66,16,689.48,2,1,2,5,212
15182,154,29,622.85,1,2,2,5,122
15184,29,62,402.2,2,2,2,6,222
15185,70,21,310.62,2,1,1,4,211
15186,14,19,411.41,3,1,2,6,312
15187,2,91,4777.18,3,3,3,9,333
15189,1,212,16225.39,3,3,3,9,333
15192,120,51,1044.32,1,2,2,5,122
15193,61,19,499.32,2,1,2,5,212
15194,3,310,7616.53,3,3,3,9,333
15195,3,1,3861,3,1,3,7,313
15197,11,32,1079.61,3,2,2,7,322
15198,92,10,193.64,1,1,1,3,111
15199,59,13,1268.7,2,1,3,6,213
15201,87,69,1236.54,2,2,3,7,223
15203,26,142,1827.8,2,3,3,8,233
15204,357,9,316.58,1,1,1,3,111
15205,85,37,653.24,2,2,2,6,222
15206,10,9,420.3,3,1,2,6,312
15208,1,42,870.12,3,2,2,7,322
15210,225,20,331.18,1,1,1,3,111
15211,60,52,894.41,2,2,2,6,222
15212,241,5,101.8,1,1,1,3,111
15213,319,24,328.35,1,2,1,4,121
15214,2,110,1661.44,3,3,3,9,333
15215,47,35,734.94,2,2,2,6,222
15216,88,2,96.6,2,1,1,4,211
15218,11,166,5756.89,3,3,3,9,333
15219,176,9,305.75,1,1,1,3,111
15220,52,117,1778.96,2,3,3,8,233
15221,366,5,403.25,1,1,2,4,112
15222,319,5,585,1,1,2,4,112
15223,226,20,755.75,1,1,2,4,112
15224,358,14,322.08,1,1,1,3,111
15225,234,23,409.4,1,1,2,4,112
15226,311,8,154.41,1,1,1,3,111
15227,37,58,1219.4,2,2,3,7,223
15228,66,125,3386.71,2,3,3,8,233
15230,239,23,429.6,1,1,2,4,112
15232,113,31,612.06,1,2,2,5,122
15234,277,14,197,1,1,1,3,111
15235,218,143,2247.51,1,3,3,7,133
15236,299,15,321.05,1,1,1,3,111
15237,2,99,1412.32,3,3,3,9,333
15238,29,50,1071.99,2,2,2,6,222
15239,10,49,780.59,3,2,2,7,322
15240,45,78,1706.57,2,3,3,8,233
15241,67,110,1756.44,2,3,3,8,233
15243,74,22,316.68,2,1,1,4,211
15244,65,34,631.57,2,2,2,6,222
15245,134,89,2515.84,1,3,3,7,133
15246,238,33,514.15,1,2,2,5,122
15247,122,6,356,1,1,1,3,111
15249,32,350,6688.46,2,3,3,8,233
15251,9,111,10484.99,3,3,3,9,333
15252,36,44,740.78,2,2,2,6,222
15253,16,53,918.2,3,2,2,7,322
15254,127,18,300.36,1,1,1,3,111
15255,67,47,890.85,2,2,2,6,222
15256,149,6,98.45,1,1,1,3,111
15257,283,7,317.15,1,1,1,3,111
15258,169,34,623.16,1,2,2,5,122
15260,100,77,1810.77,1,3,3,7,133
15261,135,19,254.82,1,1,1,3,111
15262,324,10,178.95,1,1,1,3,111
15263,107,12,156.51,1,1,1,3,111
15264,64,23,393.74,2,1,2,5,212
15265,151,82,1506.12,1,3,3,7,133
15266,338,6,119.3,1,1,1,3,111
15267,22,11,1717.36,3,1,3,7,313
15269,24,2,408.8,3,1,2,6,312
15270,16,41,2379.49,3,2,3,8,323
15271,7,264,2493.34,3,3,3,9,333
15272,57,63,721.94,2,2,2,6,222
15274,4,47,716.57,3,2,2,7,322
15275,38,41,615.14,2,2,2,6,222
15276,66,49,128.63,2,2,1,5,221
15277,47,12,255.9,2,1,1,4,211
15279,355,19,290.51,1,1,1,3,111
15280,172,16,113.12,1,1,1,3,111
15281,59,139,2332.15,2,3,3,8,233
15286,50,3,240.55,2,1,1,4,211
15287,22,20,486.69,3,1,2,6,312
15288,43,88,2306.52,2,3,3,8,233
15289,29,58,939.78,2,2,2,6,222
15290,5,204,7943.22,3,3,3,9,333
15291,26,103,4668.3,2,3,3,8,233
15292,201,24,178.39,1,2,1,4,121
15296,51,194,3672.86,2,3,3,8,233
15297,10,39,641.94,3,2,2,7,322
15298,2,192,4799.9,3,3,3,9,333
15299,67,7,4507.01,2,1,3,6,213
15300,64,28,496.44,2,2,2,6,222
15301,51,242,5049.95,2,3,3,8,233
15303,290,31,574.02,1,2,2,5,122
15304,61,23,694.4,2,1,2,5,212
15306,64,58,1174.35,2,2,2,6,222
15307,96,12,205.3,1,1,1,3,111
15308,274,19,310.47,1,1,1,3,111
15311,1,2366,60632.75,3,3,3,9,333
15312,75,47,924.85,2,2,2,6,222
15313,110,1,52,1,1,1,3,111
15314,199,24,327.97,1,2,1,4,121
15315,64,37,570.5,2,2,2,6,222
15316,327,1,165,1,1,1,3,111
15318,4,33,312.62,3,2,1,6,321
15319,284,16,204.5,1,1,1,3,111
15320,44,36,267.13,2,2,1,5,221
15321,71,95,2748.31,2,3,3,8,233
15322,86,42,679.68,2,2,2,6,222
15325,104,48,161.74,1,2,1,4,121
15326,334,29,311.71,1,2,1,4,121
15327,53,10,208.75,2,1,1,4,211
15329,39,57,1049.7,2,2,2,6,222
15330,32,13,714.96,2,1,2,5,212
15332,366,35,1661.06,1,2,3,6,123
15333,208,16,1028.56,1,1,2,4,112
15334,157,98,350.82,1,3,1,5,131
15335,54,35,170.22,2,2,1,5,221
15339,66,86,574.07,2,3,2,7,232
15341,81,17,2020.52,2,1,3,6,213
15342,130,24,406.09,1,2,2,5,122
15343,87,21,364.5,2,1,1,4,211
15344,1,26,563.94,3,2,2,7,322
15345,46,20,393.54,2,1,2,5,212
15346,333,17,252.42,1,1,1,3,111
15347,366,5,201.6,1,1,1,3,111
15348,72,9,158.04,2,1,1,4,211
15349,158,71,463.91,1,2,2,5,122
15350,373,5,115.65,1,1,1,3,111
15351,12,219,1934.66,3,3,3,9,333
15353,255,61,770.12,1,2,2,5,122
15355,29,14,277.05,2,1,1,4,211
15356,31,499,2718.03,2,3,3,8,233
15358,5,551,8347.2,3,3,3,9,333
15360,40,13,427.93,2,1,2,5,212
15361,362,7,418.92,1,1,2,4,112
15363,373,16,326,1,1,1,3,111
15364,96,29,913.19,1,2,2,5,122
15365,26,114,2314.32,2,3,3,8,233
15366,75,44,602.51,2,2,2,6,222
15367,57,95,1877.59,2,3,3,8,233
15368,21,4,446.94,3,1,2,6,312
15370,41,94,2386.05,2,3,3,8,233
15372,137,27,2007.4,1,2,3,6,123
15373,8,132,2415.91,3,3,3,9,333
15374,129,3,168,1,1,1,3,111
15376,40,116,1221.56,2,3,3,8,233
15379,169,194,3703.29,1,3,3,7,133
15380,9,36,1690.26,3,2,3,8,323
15381,214,8,596.85,1,1,2,4,112
15382,15,302,5955.71,3,3,3,9,333
15384,170,41,642.41,1,2,2,5,122
15385,40,12,316.88,2,1,1,4,211
15386,186,31,394.14,1,2,2,5,122
15388,270,10,140.54,1,1,1,3,111
15389,172,1,500,1,1,2,4,112
15392,5,84,1535.53,3,3,3,9,333
15393,16,12,231.86,3,1,1,5,311
15394,10,85,2183.54,3,3,3,9,333
15395,326,7,107.45,1,1,1,3,111
15396,113,14,288.18,1,1,1,3,111
15397,290,6,94,1,1,1,3,111
15398,16,73,1345.53,3,3,3,9,333
15399,1,50,815.77,3,2,2,7,322
15400,92,12,716.2,1,1,2,4,112
15402,149,42,626.77,1,2,2,5,122
15405,189,8,349.1,1,1,1,3,111
15406,31,53,510.71,2,2,2,6,222
15407,34,148,1046.74,2,3,2,7,232
15408,264,34,267.18,1,2,1,4,121
15410,84,122,3450.84,2,3,3,8,233
15411,26,98,1348.93,2,3,3,8,233
15412,171,10,190.53,1,1,1,3,111
15414,10,39,774.9,3,2,2,7,322
15415,313,47,559.61,1,2,2,5,122
15416,65,192,3984.32,2,3,3,8,233
15417,85,28,508.8,2,2,2,6,222
15419,25,8,135.86,3,1,1,5,311
15421,59,53,950.36,2,2,2,6,222
15422,323,6,97.7,1,1,1,3,111
15423,38,2,43.5,2,1,1,4,211
15424,254,17,383.34,1,1,1,3,111
15426,19,275,1404.07,3,3,3,9,333
15427,33,292,1430.54,2,3,3,8,233
15428,15,6,93.78,3,1,1,5,311
15429,27,82,397.35,2,3,2,7,232
15432,23,10,171.19,3,1,1,5,311
15433,214,41,533.3,1,2,2,5,122
15434,8,55,1041.48,3,2,2,7,322
15435,22,29,149.29,3,2,1,6,321
15436,12,291,1067.75,3,3,2,8,332
15437,262,45,200.16,1,2,1,4,121
15438,131,25,156.58,1,2,1,4,121
15440,55,62,383.68,2,2,1,5,221
15442,249,2,594,1,1,2,4,112
15443,2,372,3213.59,3,3,3,9,333
15444,9,214,1411.21,3,3,3,9,333
15445,264,5,113.5,1,1,1,3,111
15447,331,9,155.17,1,1,1,3,111
15448,313,28,494.64,1,2,2,5,122
15449,26,60,974.52,2,2,2,6,222
15450,30,30,429.84,2,2,2,6,222
15452,30,56,528.48,2,2,2,6,222
15453,2,279,1371.77,3,3,3,9,333
15454,362,25,179.1,1,2,1,4,121
15456,283,58,434.59,1,2,2,5,122
15457,262,58,237.07,1,2,1,4,121
15458,25,7,161.64,3,1,1,5,311
15460,354,56,214.26,1,2,1,4,121
15462,94,11,234.6,1,1,1,3,111
15463,29,7,126.14,2,1,1,4,211
15464,338,155,1044.65,1,3,2,6,132
15465,20,97,7354.62,3,3,3,9,333
15466,85,57,334.53,2,2,1,5,221
15467,9,52,524.88,3,2,2,7,322
15468,51,24,467.51,2,2,2,6,222
15469,50,24,538.55,2,2,2,6,222
15471,2,73,454.48,3,3,2,8,332
15472,113,76,371.56,1,3,1,5,131
15473,14,11,1771.2,3,1,3,7,313
15475,77,29,454.11,2,2,2,6,222
15478,40,44,1399.92,2,2,3,7,223
15480,116,45,905.5,1,2,2,5,122
15482,16,97,10879.76,3,3,3,9,333
15483,161,84,225.26,1,3,1,5,131
15484,1,187,3590.41,3,3,3,9,333
15485,30,85,2564.5,2,3,3,8,233
15488,93,2,91.32,1,1,1,3,111
15489,23,50,1134.28,3,2,2,7,322
15491,95,154,3100.09,1,3,3,7,133
15492,28,35,659.46,2,2,2,6,222
15493,33,289,1953.41,2,3,3,8,233
15494,21,122,1280.58,3,3,3,9,333
15497,18,15,1262.2,3,1,3,7,313
15498,3,512,13316.4,3,3,3,9,333
15500,8,68,1131.56,3,2,2,7,322
15502,16,213,10384.93,3,3,3,9,333
15503,363,66,141.04,1,2,1,4,121
15504,81,13,52.83,2,1,1,4,211
15505,53,97,3610.96,2,3,3,8,233
15506,23,161,972.08,3,3,2,8,332
15507,172,45,475.86,1,2,2,5,122
15508,189,92,1000.27,1,3,2,6,132
15510,331,1,250,1,1,1,3,111
15511,12,158,900.53,3,3,2,8,332
15512,156,7,121,1,1,1,3,111
15513,33,308,14758.22,2,3,3,8,233
15514,12,166,4023.72,3,3,3,9,333
15516,45,15,62.43,2,1,1,4,211
15517,233,27,267.03,1,2,1,4,121
15518,64,210,1921.55,2,3,3,8,233
15520,2,18,343.5,3,1,1,5,311
15521,40,185,3000.2,2,3,3,8,233
15522,33,56,397.99,2,2,2,6,222
15523,84,10,412.01,2,1,2,5,212
15524,25,1,440,3,1,2,6,312
15525,2,156,734.37,3,3,2,8,332
15526,33,4,148.44,2,1,1,4,211
15527,19,162,2428.53,3,3,3,9,333
15528,254,26,229.33,1,2,1,4,121
15529,23,662,3962.6,3,3,3,9,333
15530,22,107,1497.31,3,3,3,9,333
15531,8,219,1972.39,3,3,3,9,333
15532,25,251,1564.73,3,3,3,9,333
15533,19,83,807.57,3,3,2,8,332
15535,173,72,502.9,1,2,2,5,122
15537,163,24,110.92,1,2,1,4,121
15539,7,41,538.46,3,2,2,7,322
15540,11,15,213.3,3,1,1,5,311
15541,114,29,85.13,1,2,1,4,121
15543,288,28,127.86,1,2,1,4,121
15544,9,259,3546.71,3,3,3,9,333
15545,54,80,288.97,2,3,1,6,231
15547,7,695,4910.6,3,3,3,9,333
15549,77,114,1681.46,2,3,3,8,233
15550,4,61,575.63,3,2,2,7,322
15551,37,29,436.06,2,2,2,6,222
15552,217,17,90.12,1,1,1,3,111
15553,60,55,428.93,2,2,2,6,222
15554,278,14,217.2,1,1,1,3,111
15555,12,887,4794.86,3,3,3,9,333
15556,24,31,279.77,3,2,1,6,321
15557,29,19,468.91,2,1,2,5,212
15561,12,27,800.59,3,2,2,7,322
15562,352,1,134.55,1,1,1,3,111
15563,22,113,1400.44,3,3,3,9,333
15565,50,8,173.16,2,1,1,4,211
15567,19,7,186.01,3,1,1,5,311
15568,3,53,758.29,3,2,2,7,322
15569,104,31,1375.71,1,2,3,6,123
15570,7,319,4148.82,3,3,3,9,333
15571,12,57,650.43,3,2,2,7,322
15572,5,212,2533.42,3,3,3,9,333
15573,32,97,591.19,2,3,2,7,232
15574,178,152,675.64,1,3,2,6,132
15576,38,43,921.37,2,2,2,6,222
15577,151,39,258.88,1,2,1,4,121
15578,162,13,127.1,1,1,1,3,111
15579,69,48,327.6,2,2,1,5,221
15581,121,146,3675.77,1,3,3,7,133
15582,25,44,682.91,3,2,2,7,322
15584,24,122,720.86,3,3,2,8,332
15585,177,31,455.3,1,2,2,5,122
15587,50,9,913.68,2,1,2,5,212
15589,256,29,478.53,1,2,2,5,122
15592,47,24,388.58,2,2,2,6,222
15593,71,5,199.8,2,1,1,4,211
15594,16,103,1771.78,3,3,3,9,333
15596,101,77,1406.59,1,3,3,7,133
15597,35,22,324.57,2,1,1,4,211
15598,53,14,240.68,2,1,1,4,211
15599,27,52,761.74,2,2,2,6,222
15601,11,410,6776.56,3,3,3,9,333
15602,8,46,1297.87,3,2,3,8,323
15603,79,2,48.48,2,1,1,4,211
15604,52,17,216.39,2,1,1,4,211
15605,36,67,1198.23,2,2,3,7,223
15606,61,77,2920.16,2,3,3,8,233
15607,337,13,104.76,1,1,1,3,111
15608,28,60,1093.68,2,2,2,6,222
15609,184,16,298.48,1,1,1,3,111
15610,52,6,112.46,2,1,1,4,211
15611,10,43,1591.45,3,2,3,8,323
15612,36,6,195.15,2,1,1,4,211
15615,10,423,10399.74,3,3,3,9,333
15618,33,45,776.851,2,2,2,6,222
15619,11,3,336.4,3,1,1,5,311
15620,57,100,1553.18,2,3,3,8,233
15621,4,16,1293.03,3,1,3,7,313
15622,43,185,3709.56,2,3,3,8,233
15623,141,19,301.03,1,1,1,3,111
15624,117,34,588.13,1,2,2,5,122
15625,104,64,1534.26,1,2,3,6,123
15626,75,49,675.8,2,2,2,6,222
15628,5,155,2870.24,3,3,3,9,333
15630,45,60,1186.35,2,2,2,6,222
15632,16,167,3285.31,3,3,3,9,333
15634,17,15,243.55,3,1,1,5,311
15636,90,25,724.76,2,2,2,6,222
15637,53,15,223.36,2,1,1,4,211
15639,134,25,425.32,1,2,2,5,122
15640,4,476,12416.11,3,3,3,9,333
15641,105,119,1887.2,1,3,3,7,133
15643,192,33,664,1,2,2,5,122
15644,166,232,803.54,1,3,2,6,132
15645,19,52,612.01,3,2,2,7,322
15646,158,35,447.64,1,2,2,5,122
15648,204,24,639.5,1,2,2,5,122
15649,336,2,816,1,1,2,4,112
15651,37,32,646.3,2,2,2,6,222
15652,91,21,337.74,2,1,1,4,211
15653,93,6,877.44,1,1,2,4,112
15654,9,21,922.53,3,1,2,6,312
15655,243,34,560.67,1,2,2,5,122
15656,45,47,748.5,2,2,2,6,222
15657,23,1,30,3,1,1,5,311
15658,190,48,1024.1,1,2,2,5,122
15659,44,11,306.45,2,1,1,4,211
15660,25,90,1600.86,3,3,3,9,333
15661,317,5,309.8,1,1,1,3,111
15663,106,9,138.14,1,1,1,3,111
15664,51,17,386.43,2,1,1,4,211
15665,168,115,2222.21,1,3,3,7,133
15667,40,13,301.32,2,1,1,4,211
15668,218,1,76.32,1,1,1,3,111
15669,40,33,684.34,2,2,2,6,222
15670,297,12,173.05,1,1,1,3,111
15671,19,78,2657.13,3,3,3,9,333
15673,88,138,2726.23,2,3,3,8,233
15674,73,114,2446.6,2,3,3,8,233
15675,81,21,323.69,2,1,1,4,211
15676,19,202,3435.76,3,3,3,9,333
15677,49,33,657.23,2,2,2,6,222
15678,53,12,352.7,2,1,1,4,211
15679,24,110,781.28,3,3,2,8,332
15680,9,78,1333.68,3,3,3,9,333
15681,25,53,1426.16,3,2,3,8,323
15683,117,10,193.75,1,1,1,3,111
15687,9,166,2993.1,3,3,3,9,333
15689,120,9,254.1,1,1,1,3,111
15690,4,19,239.76,3,1,1,5,311
15691,252,2,136.8,1,1,1,3,111
15692,28,12,191.04,2,1,1,4,211
15694,1,78,6479.4,3,3,3,9,333
15695,267,22,409.98,1,1,2,4,112
15696,33,168,2711.11,2,3,3,8,233
15699,18,18,309.65,3,1,1,5,311
15700,172,86,696.68,1,3,2,6,132
15701,2,230,1529,3,3,3,9,333
15703,265,5,211.5,1,1,1,3,111
15704,140,117,2293.62,1,3,3,7,133
15705,201,6,143.1,1,1,1,3,111
15706,64,55,1060.56,2,2,2,6,222
15707,35,205,916.98,2,3,2,7,232
15708,41,273,3235.25,2,3,3,8,233
15709,284,6,133.25,1,1,1,3,111
15712,9,53,1072.36,3,2,2,7,322
15713,143,19,356.7,1,1,1,3,111
15714,12,34,330.03,3,2,1,6,321
15716,146,117,1101.11,1,3,2,6,132
15717,234,7,150.3,1,1,1,3,111
15719,33,931,5030.07,2,3,3,8,233
15720,24,128,598.73,3,3,2,8,332
15721,12,84,471.4,3,3,2,8,332
15722,36,67,2211.21,2,2,3,7,223
15723,365,38,190.7,1,2,1,4,121
15724,201,11,218.25,1,1,1,3,111
15725,15,32,415.25,3,2,2,7,322
15727,17,301,5159.06,3,3,3,9,333
15729,213,5,85,1,1,1,3,111
15730,66,70,1120.88,2,2,2,6,222
15732,212,14,294.12,1,1,1,3,111
15733,283,10,162.3,1,1,1,3,111
15734,115,26,1339.45,1,2,3,6,123
15737,15,71,1188.12,3,2,2,7,322
15738,19,173,4812.42,3,3,3,9,333
15739,66,8,449.12,2,1,2,5,212
15740,49,9,154.88,2,1,1,4,211
15743,16,86,775.96,3,3,2,8,332
15744,78,3,34.8,2,1,1,4,211
15745,19,62,1094.59,3,2,2,7,322
15746,134,28,196.88,1,2,1,4,121
15747,13,90,946.64,3,3,2,8,332
15748,40,20,144.36,2,1,1,4,211
15749,235,10,44534.3,1,1,3,5,113
15750,3,291,2463.05,3,3,3,9,333
15752,40,405,2626.6,2,3,3,8,233
15753,305,1,79.2,1,1,1,3,111
15754,51,28,458.57,2,2,2,6,222
15755,10,141,2364.25,3,3,3,9,333
15756,61,191,528.01,2,3,2,7,232
15757,66,45,714.42,2,2,2,6,222
15758,25,9,205.25,3,1,1,5,311
15759,218,7,253.04,1,1,1,3,111
15762,65,37,583.75,2,2,2,6,222
15763,32,61,1086.92,2,2,2,6,222
15764,88,180,3279.97,2,3,3,8,233
15766,64,11,315.06,2,1,1,4,211
15768,116,27,621.83,1,2,2,5,122
15769,7,130,56252.72,3,3,3,9,333
15773,6,10,635.68,3,1,2,6,312
15774,69,25,270.8,2,2,1,5,221
15775,245,7,104.9,1,1,1,3,111
15776,133,18,241.62,1,1,1,3,111
15777,241,21,1047.11,1,1,2,4,112
15780,184,29,475.28,1,2,2,5,122
15781,25,20,345.46,3,1,1,5,311
15782,10,43,2614.74,3,2,3,8,323
15783,11,14,246.3,3,1,1,5,311
15785,33,83,2328.97,2,3,3,8,233
15786,46,266,4919,2,3,3,8,233
15787,26,200,933.26,2,3,2,7,232
15789,358,25,351.3,1,2,1,4,121
15790,10,34,218.75,3,2,1,6,321
15791,44,75,1612.69,2,3,3,8,233
15793,15,12,965.61,3,1,2,6,312
15795,150,42,610.01,1,2,2,5,122
15796,1,132,2708.61,3,3,3,9,333
15797,113,8,2207.4,1,1,3,5,113
15799,76,98,884.14,2,3,2,7,232
15800,107,117,696.89,1,3,2,6,132
15801,46,64,1063.95,2,2,2,6,222
15802,143,1,451.42,1,1,2,4,112
15803,51,8,415.82,2,1,2,5,212
15804,1,262,4206.39,3,3,3,9,333
15805,23,299,5488.18,3,3,3,9,333
15806,46,31,784.58,2,2,2,6,222
15807,50,48,903.9,2,2,2,6,222
15808,306,195,3651.27,1,3,3,7,133
15809,36,35,515.77,2,2,2,6,222
15810,79,89,1391.98,2,3,3,8,233
15811,22,133,2218.62,3,3,3,9,333
15812,107,41,1801.14,1,2,3,6,123
15813,208,40,1303.91,1,2,3,6,123
15814,17,72,1945.33,3,2,3,8,323
15815,64,49,2100.6,2,2,3,7,223
15819,49,123,1905.45,2,3,3,8,233
15820,320,17,206.98,1,1,1,3,111
15821,44,62,570.96,2,2,2,6,222
15822,3,33,885.47,3,2,2,7,322
15823,372,1,15,1,1,1,3,111
15825,172,20,532.94,1,1,2,4,112
15826,56,68,1654.31,2,2,3,7,223
15827,73,115,1836.09,2,3,3,8,233
15829,99,51,636.14,1,2,2,5,122
15830,38,39,576,2,2,2,6,222
15831,58,66,794.64,2,2,2,6,222
15832,254,54,836.79,1,2,2,5,122
15834,70,269,2225.15,2,3,3,8,233
15835,44,50,954.09,2,2,2,6,222
15836,50,10,137.37,2,1,1,4,211
15837,65,24,391.98,2,2,2,6,222
15838,11,167,33643.08,3,3,3,9,333
15839,33,62,1048.49,2,2,2,6,222
15840,59,27,355.56,2,2,1,5,221
15841,73,47,1224.06,2,2,3,7,223
15843,304,8,118.95,1,1,1,3,111
15844,46,11,130.74,2,1,1,4,211
15845,18,138,3711.77,3,3,3,9,333
15847,38,22,389.27,2,1,2,5,212
15850,19,93,234.88,3,3,1,7,331
15852,187,22,160.71,1,1,1,3,111
15853,52,30,110.8,2,2,1,5,221
15854,4,138,2969.12,3,3,3,9,333
15855,137,80,712.24,1,3,2,6,132
15856,4,628,16143.64,3,3,3,9,333
15857,19,14,297,3,1,1,5,311
15858,16,188,1427.57,3,3,3,9,333
15860,41,139,965.16,2,3,2,7,232
15861,12,540,3146.92,3,3,3,9,333
15862,8,147,832.88,3,3,2,8,332
15863,26,18,68.84,2,1,1,4,211
15864,22,20,1936.32,3,1,3,7,313
15865,41,40,895.13,2,2,2,6,222
15866,101,43,211.89,1,2,1,4,121
15867,5,459,3810.14,3,3,3,9,333
15869,277,15,149.64,1,1,1,3,111
15870,33,74,351.44,2,3,1,6,231
15872,15,108,316.25,3,3,1,7,331
15874,64,120,4405.88,2,3,3,8,233
15877,2,126,490.33,3,3,2,8,332
15880,369,96,329.03,1,3,1,5,131
15881,312,29,501.39,1,2,2,5,122
15882,199,23,516.36,1,1,2,4,112
15883,2,49,396.48,3,2,2,7,322
15885,93,18,379.35,1,1,1,3,111
15886,60,12,181.09,2,1,1,4,211
15888,81,12,168.31,2,1,1,4,211
15889,157,85,420.07,1,3,2,6,132
15891,227,60,511.68,1,2,2,5,122
15894,253,37,258.25,1,2,1,4,121
15895,150,11,179.17,1,1,1,3,111
15897,194,22,208.59,1,1,1,3,111
15898,1,84,1383.83,3,3,3,9,333
15899,369,4,56.25,1,1,1,3,111
15900,24,47,337.28,3,2,1,6,321
15901,17,111,351.73,3,3,1,7,331
15903,10,74,5126.76,3,3,3,9,333
15904,8,30,164.68,3,2,1,6,321
15906,20,150,1567.69,3,3,3,9,333
15907,4,226,882.72,3,3,2,8,332
15909,174,7,191.94,1,1,1,3,111
15910,1,266,1228.88,3,3,3,9,333
15912,178,19,264.62,1,1,1,3,111
15916,16,151,1502.86,3,3,3,9,333
15917,248,12,123.1,1,1,1,3,111
15918,191,40,334.23,1,2,1,4,121
15919,20,122,525.69,3,3,2,8,332
15920,154,60,167.5,1,2,1,4,121
15921,173,24,323.03,1,2,1,4,121
15922,373,11,369.5,1,1,1,3,111
15923,373,21,127.08,1,1,1,3,111
15925,194,12,207.15,1,1,1,3,111
15930,67,21,426.63,2,1,2,5,212
15932,4,115,2495.87,3,3,3,9,333
15933,21,74,1107.46,3,3,2,8,332
15935,239,12,416.86,1,1,2,4,112
15937,64,7,145.35,2,1,1,4,211
15938,112,18,404.58,1,1,2,4,112
15939,90,76,6115.01,2,3,3,8,233
15940,311,1,35.8,1,1,1,3,111
15942,134,14,337.44,1,1,1,3,111
15944,277,6,325.1,1,1,1,3,111
15945,365,2,181,1,1,1,3,111
15947,83,29,1708.24,2,2,3,7,223
15948,8,60,955.24,3,2,2,7,322
15949,17,19,364.72,3,1,1,5,311
15950,32,97,1744.71,2,3,3,8,233
15951,9,41,708.22,3,2,2,7,322
15952,34,84,781.91,2,3,2,7,232
15953,15,97,1657.28,3,3,3,9,333
15955,24,183,4416.26,3,3,3,9,333
15957,32,42,428.89,2,2,2,6,222
15958,74,7,104.35,2,1,1,4,211
15963,20,28,470.76,3,2,2,7,322
15965,17,111,808.87,3,3,2,8,332
15967,23,80,397.68,3,3,2,8,332
15969,3,20,666.1,3,1,2,6,312
15970,304,11,314.1,1,1,1,3,111
15971,18,35,4199.85,3,2,3,8,323
15973,367,4,307.82,1,1,1,3,111
15974,39,176,3442.15,2,3,3,8,233
15975,84,24,371.01,2,2,1,5,221
15976,165,96,427.64,1,3,2,6,132
15977,17,65,1054.73,3,2,2,7,322
15978,77,49,1098.78,2,2,2,6,222
15980,89,43,2398.86,2,2,3,7,223
15981,25,97,3408.48,3,3,3,9,333
15983,22,112,1465.12,3,3,3,9,333
15984,3,258,2780.63,3,3,3,9,333
15985,123,37,1142.42,1,2,2,5,122
15986,30,14,168.12,2,1,1,4,211
15987,12,128,1432.77,3,3,3,9,333
15988,19,26,156.78,3,2,1,6,321
15990,44,52,792.11,2,2,2,6,222
15992,4,3,41.99,3,1,1,5,311
15993,9,543,2777.67,3,3,3,9,333
15994,55,32,414.27,2,2,2,6,222
15996,88,127,1032.58,2,3,2,7,232
15998,37,504,3080.22,2,3,3,8,233
16000,3,9,12393.7,3,1,3,7,313
16003,30,103,2735.37,2,3,3,8,233
16005,12,201,578.71,3,3,2,8,332
16006,211,8,101.4,1,1,1,3,111
16007,48,381,1693.81,2,3,3,8,233
16008,24,33,478.78,3,2,2,7,322
16009,22,82,972.11,3,3,2,8,332
16010,246,79,392.4,1,3,2,6,132
16011,8,210,3352.96,3,3,3,9,333
16012,35,94,1415.29,2,3,3,8,233
16013,4,139,37130.6,3,3,3,9,333
16014,38,138,646.83,2,3,2,7,232
16015,4,181,704.55,3,3,2,8,332
16016,3,224,1465.51,3,3,3,9,333
16017,47,32,211.88,2,2,1,5,221
16018,39,28,408.9,2,2,2,6,222
16019,47,160,3786.24,2,3,3,8,233
16020,17,46,851.01,3,2,2,7,322
16022,260,71,602.63,1,2,2,5,122
16023,46,101,719.81,2,3,2,7,232
16024,12,63,251.03,3,2,1,6,321
16025,30,28,439.66,2,2,2,6,222
16026,43,32,236.09,2,2,1,5,221
16027,92,16,934.62,1,1,2,4,112
16029,39,241,80850.84,2,3,3,8,233
16030,310,29,331.24,1,2,1,4,121
16031,92,98,547.9,1,3,2,6,132
16033,6,1128,8778.82,3,3,3,9,333
16034,196,22,437.7,1,1,2,4,112
16036,87,55,758.92,2,2,2,6,222
16037,270,39,855.02,1,2,2,5,122
16038,8,26,471.78,3,2,2,7,322
16040,65,65,1313.55,2,2,3,7,223
16041,31,6,3166.4,2,1,3,6,213
16042,22,70,1177.47,3,2,2,7,322
16043,38,39,773.99,2,2,2,6,222
16045,120,83,1340.7,1,3,3,7,133
16048,373,8,256.44,1,1,1,3,111
16049,40,299,1074.81,2,3,2,7,232
16050,174,10,137.9,1,1,1,3,111
16052,54,34,362.06,2,2,1,5,221
16053,33,84,1511.95,2,3,3,8,233
16054,145,70,783.9,1,2,2,5,122
16055,221,8,134.8,1,1,1,3,111
16056,45,66,650.75,2,2,2,6,222
16057,16,121,2263.12,3,3,3,9,333
16059,66,178,1453.16,2,3,3,8,233
16062,10,64,1153.62,3,2,2,7,322
16063,260,23,335.32,1,1,1,3,111
16065,365,73,367.14,1,3,1,5,131
16066,17,101,1521.04,3,3,3,9,333
16070,22,33,852.15,3,2,2,7,322
16071,45,21,326.24,2,1,1,4,211
16072,288,23,584.32,1,1,2,4,112
16073,297,1,122.4,1,1,1,3,111
16076,3,129,2234.73,3,3,3,9,333
16078,284,1,79.2,1,1,1,3,111
16079,17,21,1352,3,1,3,7,313
16080,82,10,217.16,2,1,1,4,211
16081,56,223,2799.42,2,3,3,8,233
16083,101,31,1317.62,1,2,3,6,123
16084,299,38,436.18,1,2,2,5,122
16085,23,167,981.51,3,3,2,8,332
16086,59,39,1121.39,2,2,2,6,222
16091,155,18,315.06,1,1,1,3,111
16092,115,51,817.86,1,2,2,5,122
16093,107,1,17,1,1,1,3,111
16094,12,63,1078.23,3,2,2,7,322
16096,264,12,320.62,1,1,1,3,111
16097,240,10,185.05,1,1,1,3,111
16098,88,67,2005.63,2,2,3,7,223
16099,50,39,731.9,2,2,2,6,222
16101,71,76,1290.7,2,3,3,8,233
16102,42,57,1842.14,2,2,3,7,223
16103,7,48,1429.64,3,2,3,8,323
16104,62,28,298.21,2,2,1,5,221
16105,249,13,336.96,1,1,1,3,111
16106,66,6,108.38,2,1,1,4,211
16107,18,31,3204.16,3,2,3,8,323
16108,85,48,842.5,2,2,2,6,222
16109,219,18,611.88,1,1,2,4,112
16110,45,342,1320.95,2,3,3,8,233
16112,143,16,195.74,1,1,1,3,111
16113,183,30,161.38,1,2,1,4,121
16114,171,8,135.75,1,1,1,3,111
16115,10,279,1660.88,3,3,3,9,333
16116,212,34,612.78,1,2,2,5,122
16117,190,30,232.21,1,2,1,4,121
16119,8,16,423.36,3,1,2,6,312
16120,59,30,1309.14,2,2,3,7,223
16121,57,204,854.66,2,3,2,7,232
16122,73,38,684.42,2,2,2,6,222
16123,52,16,307.78,2,1,1,4,211
16124,317,11,249,1,1,1,3,111
16125,367,13,289.35,1,1,1,3,111
16126,29,117,6287.77,2,3,3,8,233
16127,39,40,656.25,2,2,2,6,222
16128,18,89,1880.22,3,3,3,9,333
16131,52,78,3506.54,2,3,3,8,233
16133,4,338,14589.04,3,3,3,9,333
16134,22,35,618.09,3,2,2,7,322
16135,263,21,517.55,1,1,2,4,112
16136,60,37,709.38,2,2,2,6,222
16139,19,31,635.41,3,2,2,7,322
16140,66,35,725.18,2,2,2,6,222
16141,88,30,620.4,2,2,2,6,222
16142,250,37,535.34,1,2,2,5,122
16143,3,117,2424.94,3,3,3,9,333
16144,247,1,175.2,1,1,1,3,111
16145,9,224,3799.49,3,3,3,9,333
16146,157,29,734.13,1,2,2,5,122
16147,134,22,375,1,1,1,3,111
16148,296,1,76.32,1,1,1,3,111
16149,5,18,280.52,3,1,1,5,311
16150,43,117,2053.02,2,3,3,8,233
16152,269,29,1829.04,1,2,3,6,123
16153,50,89,1824.23,2,3,3,8,233
16156,9,128,3092.04,3,3,3,9,333
16157,16,18,656.69,3,1,2,6,312
16159,282,14,348.2,1,1,1,3,111
16160,65,20,1025.44,2,1,2,5,212
16161,2,471,5533.67,3,3,3,9,333
16162,252,2,37.4,1,1,1,3,111
16163,232,6,856.6,1,1,2,4,112
16164,17,34,822.48,3,2,2,7,322
16168,11,98,3787.6,3,3,3,9,333
16169,8,85,1822.97,3,3,3,9,333
16170,51,125,1885.05,2,3,3,8,233
16171,59,3,73.2,2,1,1,4,211
16172,95,69,1140.21,1,2,2,5,122
16173,16,84,1418.32,3,3,3,9,333
16174,126,23,1009.55,1,1,2,4,112
16175,94,58,1037.59,1,2,2,5,122
16177,50,15,331.95,2,1,1,4,211
16178,138,8,197.9,1,1,1,3,111
16179,61,11,215.83,2,1,1,4,211
16180,100,162,10254.18,1,3,3,7,133
16181,73,11,305.54,2,1,1,4,211
16182,72,28,6617.65,2,2,3,7,223
16183,67,15,338.71,2,1,1,4,211
16184,64,45,1158.79,2,2,2,6,222
16185,17,31,529.41,3,2,2,7,322
16186,23,218,4006.94,3,3,3,9,333
16187,32,295,6911.44,2,3,3,8,233
16188,45,67,981.86,2,2,2,6,222
16189,16,11,215.48,3,1,1,5,311
16190,40,6,215.08,2,1,1,4,211
16191,3,134,5180.52,3,3,3,9,333
16193,237,19,314.45,1,1,1,3,111
16198,75,15,400.681,2,1,2,5,212
16200,4,172,1068.87,3,3,2,8,332
16201,3,111,1863.47,3,3,3,9,333
16202,361,18,365.27,1,1,1,3,111
16203,59,35,592.9,2,2,2,6,222
16204,23,50,384.18,3,2,1,6,321
16205,31,97,757.63,2,3,2,7,232
16206,55,63,537.06,2,2,2,6,222
16207,25,19,394.38,3,1,2,6,312
16208,45,66,664.26,2,2,2,6,222
16209,89,46,2262.62,2,2,3,7,223
16210,2,123,21086.3,3,3,3,9,333
16211,89,23,547.02,2,1,2,5,212
16212,19,41,690.34,3,2,2,7,322
16213,79,6,159,2,1,1,4,211
16214,171,44,1062.75,1,2,2,5,122
16215,81,14,242.35,2,1,1,4,211
16216,267,37,914.93,1,2,2,5,122
16217,235,15,304.25,1,1,1,3,111
16218,30,84,3084.68,2,3,3,8,233
16221,37,95,860.86,2,3,2,7,232
16222,318,122,773.55,1,3,2,6,132
16224,57,96,1295.3,2,3,3,8,233
16225,45,134,1096.32,2,3,2,7,232
16226,203,8,255.12,1,1,1,3,111
16227,225,6,314.22,1,1,1,3,111
16229,87,47,1010.6,2,2,2,6,222
16230,190,35,542.03,1,2,2,5,122
16232,44,37,990.88,2,2,2,6,222
16233,71,22,536.68,2,1,2,5,212
16235,41,46,867.31,2,2,2,6,222
16236,78,20,432.2,2,1,2,5,212
16239,57,19,414.2,2,1,2,5,212
16240,24,135,3718.8,3,3,3,9,333
16241,10,655,2590.31,3,3,3,9,333
16242,8,292,3579.86,3,3,3,9,333
16243,34,51,409.1,2,2,2,6,222
16244,212,91,1522.75,1,3,3,7,133
16245,24,90,1413.66,3,3,3,9,333
16247,170,16,114.56,1,1,1,3,111
16248,62,7,152.94,2,1,1,4,211
16249,53,69,1800.07,2,2,3,7,223
16250,261,24,389.44,1,2,2,5,122
16253,67,123,3683.86,2,3,3,8,233
16255,17,270,2619.91,3,3,3,9,333
16256,267,13,752.43,1,1,2,4,112
16257,177,2,46.95,1,1,1,3,111
16258,45,135,5203.51,2,3,3,8,233
16260,51,18,1035.45,2,1,2,5,212
16261,17,119,728.54,3,3,2,8,332
16265,9,258,5447,3,3,3,9,333
16266,74,61,861.89,2,2,2,6,222
16268,71,45,667.65,2,2,2,6,222
16270,353,54,1141.24,1,2,2,5,122
16271,3,130,1404.64,3,3,3,9,333
16272,117,25,411.7,1,2,2,5,122
16274,373,65,351.75,1,2,1,4,121
16275,197,33,559.87,1,2,2,5,122
16276,177,6,810.6,1,1,2,4,112
16278,100,23,566.38,1,1,2,4,112
16279,21,106,1502.78,3,3,3,9,333
16281,72,17,2062.06,2,1,3,6,213
16282,340,11,168.3,1,1,1,3,111
16283,6,166,1570.81,3,3,3,9,333
16284,31,103,812.68,2,3,2,7,232
16287,170,8,142.5,1,1,1,3,111
16292,122,17,302.25,1,1,1,3,111
16293,22,118,2248.99,3,3,3,9,333
16295,10,79,1328.55,3,3,3,9,333
16297,269,20,301.9,1,1,1,3,111
16298,23,27,598.2,3,2,2,7,322
16302,127,11,233.22,1,1,1,3,111
16303,26,162,5360.63,2,3,3,8,233
16305,139,22,361.22,1,1,1,3,111
16306,214,41,632.27,1,2,2,5,122
16308,38,4,2560,2,1,3,6,213
16309,106,42,706.57,1,2,2,5,122
16311,18,37,616.26,3,2,2,7,322
16313,3,16,274.15,3,1,1,5,311
16315,331,14,226.37,1,1,1,3,111
16316,64,151,2938.91,2,3,3,8,233
16317,120,69,1341.65,1,2,3,6,123
16318,35,19,328.15,2,1,1,4,211
16319,218,3,404.4,1,1,2,4,112
16320,172,56,1038.46,1,2,2,5,122
16321,72,12,373.65,2,1,1,4,211
16322,1,37,326.75,3,2,1,6,321
16323,196,1,207.5,1,1,1,3,111
16324,128,111,408.59,1,3,2,6,132
16325,47,18,594.24,2,1,2,5,212
16326,6,300,3039.22,3,3,3,9,333
16327,14,317,3820.27,3,3,3,9,333
16330,18,39,251.91,3,2,1,6,321
16332,28,151,1582.8,2,3,3,8,233
16333,8,45,26626.8,3,2,3,8,323
16337,37,10,151.05,2,1,1,4,211
16338,157,11,214.8,1,1,1,3,111
16339,284,18,94.05,1,1,1,3,111
16340,107,141,534.31,1,3,2,6,132
16341,25,77,1971.87,3,3,3,9,333
16342,75,15,322.41,2,1,1,4,211
16343,16,43,328.58,3,2,1,6,321
16344,158,2,101.1,1,1,1,3,111
16345,44,37,565.46,2,2,2,6,222
16347,11,85,847.45,3,3,2,8,332
16348,32,222,1415.65,2,3,3,8,233
16349,291,9,53.5,1,1,1,3,111
16350,21,57,1116.47,3,2,2,7,322
16351,333,8,153.9,1,1,1,3,111
16352,18,28,494.44,3,2,2,7,322
16353,4,94,6675.71,3,3,3,9,333
16354,63,39,395.8,2,2,2,6,222
16356,198,31,211.77,1,2,1,4,121
16357,33,34,658.88,2,2,2,6,222
16358,1,109,2027.5,3,3,3,9,333
16359,7,66,1750.92,3,2,3,8,323
16360,5,636,3450.41,3,3,3,9,333
16361,10,104,891.21,3,3,2,8,332
16362,32,77,709.99,2,3,2,7,232
16363,53,5,109.36,2,1,1,4,211
16364,12,52,705.79,3,2,2,7,322
16365,18,51,1540.42,3,2,3,8,323
16366,19,18,327.3,3,1,1,5,311
16367,37,127,800.67,2,3,2,7,232
16368,2,69,479.91,3,2,2,7,322
16369,18,117,1545.41,3,3,3,9,333
16370,82,221,1301.91,2,3,3,8,233
16372,33,92,355.73,2,3,1,6,231
16374,66,109,466.73,2,3,2,7,232
16376,9,122,974.96,3,3,2,8,332
16377,267,5,676.2,1,1,2,4,112
16378,247,23,362.95,1,1,1,3,111
16379,4,108,2157.4,3,3,3,9,333
16380,61,31,1743.15,2,2,3,7,223
16383,75,98,643.76,2,3,2,7,232
16384,90,33,584.5,2,2,2,6,222
16385,60,57,554.86,2,2,2,6,222
16386,29,81,302.57,2,3,1,6,231
16387,323,4,94.36,1,1,1,3,111
16389,53,34,1382.07,2,2,3,7,223
16392,270,43,217.89,1,2,1,4,121
16393,2,327,3040.96,3,3,3,9,333
16394,57,83,1555.34,2,3,3,8,233
16395,61,206,1482.06,2,3,3,8,233
16398,154,82,1705.8,1,3,3,7,133
16399,19,72,408.02,3,2,2,7,322
16400,95,29,303.93,1,2,1,4,121
16401,1,186,4098.32,3,3,3,9,333
16402,265,57,293.45,1,2,1,4,121
16403,312,10,177.5,1,1,1,3,111
16404,70,23,443.05,2,1,2,5,212
16405,302,5,167.25,1,1,1,3,111
16406,19,58,154.35,3,2,1,6,321
16407,13,168,2079.68,3,3,3,9,333
16409,36,231,2022.98,2,3,3,8,233
16411,19,44,211.7,3,2,1,6,321
16412,54,30,135.99,2,2,1,5,221
16413,57,31,262.2,2,2,1,5,221
16414,22,7,126.25,3,1,1,5,311
16415,44,47,200.27,2,2,1,5,221
16416,27,71,1051.4,2,2,2,6,222
16418,45,95,631.12,2,3,2,7,232
16419,113,50,958.71,1,2,2,5,122
16422,17,369,34684.4,3,3,3,9,333
16423,25,18,346.12,3,1,1,5,311
16424,191,5,133.56,1,1,1,3,111
16425,302,21,302.7,1,1,1,3,111
16426,2,353,1863.76,3,3,3,9,333
16427,263,9,241.06,1,1,1,3,111
16429,106,2,284.55,1,1,1,3,111
16430,57,6,300.85,2,1,1,4,211
16431,213,76,623.28,1,3,2,6,132
16432,64,8,287.4,2,1,1,4,211
16433,28,17,184.26,2,1,1,4,211
16434,29,107,1511.8,2,3,3,8,233
16438,6,132,798.35,3,3,2,8,332
16440,8,282,3640.67,3,3,3,9,333
16441,67,24,381.2,2,2,1,5,221
16442,2,171,609.3,3,3,2,8,332
16444,46,84,654.67,2,3,2,7,232
16445,34,63,230.51,2,2,1,5,221
16446,1,3,168472.5,3,1,3,7,313
16447,136,34,255.91,1,2,1,4,121
16448,198,19,182.99,1,1,1,3,111
16449,198,40,707.69,1,2,2,5,122
16450,150,11,311.92,1,1,1,3,111
16451,88,14,266.97,2,1,1,4,211
16454,45,2,6.9,2,1,1,4,211
16455,64,99,1841.18,2,3,3,8,233
16456,99,110,2158.18,1,3,3,7,133
16457,218,9,208.36,1,1,1,3,111
16458,3,202,3482.74,3,3,3,9,333
16460,28,132,811.23,2,3,2,7,232
16461,178,32,142.92,1,2,1,4,121
16462,74,3,136,2,1,1,4,211
16463,21,82,1422.4,3,3,3,9,333
16464,20,230,1298.66,3,3,3,9,333
16466,34,146,1595.96,2,3,3,8,233
16468,74,2,74.9,2,1,1,4,211
16469,24,171,625.42,3,3,2,8,332
16470,52,164,752.77,2,3,2,7,232
16471,275,13,223.95,1,1,1,3,111
16473,165,18,316.11,1,1,1,3,111
16474,7,337,1810.65,3,3,3,9,333
16475,88,28,544.3,2,2,2,6,222
16477,64,146,2494.46,2,3,3,8,233
16478,25,17,331,3,1,1,5,311
16479,10,35,300.83,3,2,1,6,321
16480,76,53,769.29,2,2,2,6,222
16482,16,18,220.62,3,1,1,5,311
16483,192,19,139.35,1,1,1,3,111
16484,174,25,404.3,1,2,2,5,122
16485,77,42,363.65,2,2,1,5,221
16488,33,29,498.8,2,2,2,6,222
16491,47,39,731.5,2,2,2,6,222
16493,80,56,1351.63,2,2,3,7,223
16494,297,50,826.53,1,2,2,5,122
16495,3,88,648.26,3,3,2,8,332
16496,9,95,1599.52,3,3,3,9,333
16497,50,136,2965.69,2,3,3,8,233
16498,161,15,100.97,1,1,1,3,111
16499,360,19,365.45,1,1,1,3,111
16500,5,11,400.86,3,1,2,6,312
16503,107,84,1431.93,1,3,3,7,133
16504,25,83,465.88,3,3,2,8,332
16505,32,4,777.6,2,1,2,5,212
16506,20,3,90.3,3,1,1,5,311
16509,297,13,363.7,1,1,1,3,111
16510,372,13,248.1,1,1,1,3,111
16511,22,159,918.33,3,3,2,8,332
16513,5,35,874.59,3,2,2,7,322
16515,52,111,1624.14,2,3,3,8,233
16516,30,6,101.7,2,1,1,4,211
16517,277,17,162.7,1,1,1,3,111
16518,61,40,484.32,2,2,2,6,222
16519,25,13,215.08,3,1,1,5,311
16520,186,156,1046.57,1,3,2,6,132
16523,2,290,9418.47,3,3,3,9,333
16525,2,183,13027.45,3,3,3,9,333
16526,172,15,290.36,1,1,1,3,111
16527,81,14,228.06,2,1,1,4,211
16528,4,17,244.41,3,1,1,5,311
16529,190,30,455.25,1,2,2,5,122
16531,22,77,1244.59,3,3,3,9,333
16532,18,4,6748.8,3,1,3,7,313
16533,19,176,1082.81,3,3,2,8,332
16535,5,31,593.75,3,2,2,7,322
16536,110,54,548.12,1,2,2,5,122
16539,3,45,1388.81,3,2,3,8,323
16542,54,5,119.62,2,1,1,4,211
16545,165,3,339.3,1,1,1,3,111
16546,291,25,787.15,1,2,2,5,122
16549,10,925,4034.9,3,3,3,9,333
16550,109,251,2298.97,1,3,3,7,133
16551,96,32,922.12,1,2,2,5,122
16552,243,17,379.73,1,1,1,3,111
16553,163,84,5719.82,1,3,3,7,133
16554,42,52,837.1,2,2,2,6,222
16555,35,17,285.89,2,1,1,4,211
16556,67,207,3313.79,2,3,3,8,233
16557,24,11,281.85,3,1,1,5,311
16558,1,460,8338.49,3,3,3,9,333
16560,27,56,841.41,2,2,2,6,222
16561,6,31,511.12,3,2,2,7,322
16563,54,19,1077.74,2,1,2,5,212
16565,364,3,173.7,1,1,1,3,111
16566,15,18,614.66,3,1,2,6,312
16567,194,35,865.6,1,2,2,5,122
16569,3,5,124.2,3,1,1,5,311
16570,15,126,3738.4,3,3,3,9,333
16571,27,87,1421.69,2,3,3,8,233
16572,127,57,1009.6,1,2,2,5,122
16573,85,42,663.61,2,2,2,6,222
16574,71,28,451.44,2,2,2,6,222
16581,183,9,105.84,1,1,1,3,111
16582,113,6,313.62,1,1,1,3,111
16583,374,14,233.45,1,1,1,3,111
16584,80,28,936.08,2,2,2,6,222
16586,249,8,463.95,1,1,2,4,112
16587,232,13,225.15,1,1,1,3,111
16589,71,33,459.24,2,2,2,6,222
16591,69,10,213.5,2,1,1,4,211
16592,4,216,4113.68,3,3,3,9,333
16593,51,27,330.03,2,2,1,5,221
16594,75,53,181.09,2,2,1,5,221
16595,61,85,360.16,2,3,1,6,231
16596,16,12,250.15,3,1,1,5,311
16597,4,7,90.04,3,1,1,5,311
16598,286,10,145.05,1,1,1,3,111
16600,4,62,813.52,3,2,2,7,322
16601,41,30,242.7,2,2,1,5,221
16602,36,29,528.08,2,2,2,6,222
16603,75,34,482.47,2,2,2,6,222
16607,18,172,3347.71,3,3,3,9,333
16609,15,276,5493.46,3,3,3,9,333
16610,219,6,75.66,1,1,1,3,111
16611,186,10,129.49,1,1,1,3,111
16612,33,66,1187.66,2,2,2,6,222
16613,70,30,618.59,2,2,2,6,222
16614,183,26,506.19,1,2,2,5,122
16616,15,33,500.42,3,2,2,7,322
16617,236,5,151.85,1,1,1,3,111
16618,31,96,2647.59,2,3,3,8,233
16619,264,14,226.21,1,1,1,3,111
16620,4,9,178.96,3,1,1,5,311
16621,52,29,813.48,2,2,2,6,222
16623,246,5,129.45,1,1,1,3,111
16624,81,48,810.57,2,2,2,6,222
16625,275,23,333.08,1,1,1,3,111
16626,1,179,4413.1,3,3,3,9,333
16627,79,20,322.8,2,1,1,4,211
16628,30,117,2188.05,2,3,3,8,233
16629,74,60,408.63,2,2,2,6,222
16633,17,152,2883.1,3,3,3,9,333
16634,223,9,217.9,1,1,1,3,111
16637,32,69,1154.47,2,2,2,6,222
16638,23,94,1680.72,3,3,3,9,333
16639,31,50,1257.51,2,2,3,7,223
16641,106,12,231.1,1,1,1,3,111
16642,5,34,688.33,3,2,2,7,322
16643,246,27,487.51,1,2,2,5,122
16644,178,62,833.78,1,2,2,5,122
16647,170,14,214.06,1,1,1,3,111
16648,43,19,290.66,2,1,1,4,211
16650,72,24,518.42,2,2,2,6,222
16652,59,118,6773.97,2,3,3,8,233
16653,16,69,1212.66,3,2,3,8,323
16654,141,29,601.27,1,2,2,5,122
16655,18,258,3789.52,3,3,3,9,333
16656,22,73,8625.8,3,3,3,9,333
16657,10,192,874.43,3,3,2,8,332
16658,368,8,123.24,1,1,1,3,111
16659,189,2,39.12,1,1,1,3,111
16660,16,16,1267.65,3,1,3,7,313
16665,362,9,135.4,1,1,1,3,111
16666,19,32,118.98,3,2,1,6,321
16667,68,52,567.18,2,2,2,6,222
16668,15,20,306.72,3,1,1,5,311
16669,24,156,1348.88,3,3,3,9,333
16670,17,252,4095.9,3,3,3,9,333
16671,28,6,1692.27,2,1,3,6,213
16672,2,114,8134.94,3,3,3,9,333
16674,55,93,304.24,2,3,1,6,231
16676,34,89,1592.12,2,3,3,8,233
16678,3,163,3109.99,3,3,3,9,333
16679,366,3,129.75,1,1,1,3,111
16680,43,10,183.7,2,1,1,4,211
16681,73,44,1770.34,2,2,3,7,223
16682,5,30,1028,3,2,2,7,322
16684,4,277,66653.56,3,3,3,9,333
16685,61,62,324.24,2,2,1,5,221
16686,47,544,2959.88,2,3,3,8,233
16688,1,62,1260.86,3,2,3,8,323
16689,76,13,422.6,2,1,2,5,212
16690,72,12,225.58,2,1,1,4,211
16692,256,3,1276,1,1,3,5,113
16693,69,59,477.86,2,2,2,6,222
16696,135,10,657.9,1,1,2,4,112
16697,241,21,112.75,1,1,1,3,111
16698,227,5,1998,1,1,3,5,113
16700,9,308,5076.55,3,3,3,9,333
16701,9,144,5398.3,3,3,3,9,333
16705,1,270,14034.99,3,3,3,9,333
16706,37,123,531.35,2,3,2,7,232
16708,46,27,656.63,2,2,2,6,222
16709,85,79,3029.87,2,3,3,8,233
16710,19,394,2467.99,3,3,3,9,333
16711,3,22,1651.03,3,1,3,7,313
16712,9,438,3611.31,3,3,3,9,333
16713,19,619,6910.78,3,3,3,9,333
16714,219,87,1129.06,1,3,2,6,132
16715,78,19,301.72,2,1,1,4,211
16716,267,2,901.2,1,1,2,4,112
16717,24,198,3843.08,3,3,3,9,333
16718,369,44,606.05,1,2,2,5,122
16719,15,196,1770.22,3,3,3,9,333
16720,26,25,152.95,2,2,1,5,221
16721,262,37,292.47,1,2,1,4,121
16722,17,225,4730.81,3,3,3,9,333
16723,91,42,576.4,2,2,2,6,222
16725,302,145,758.27,1,3,2,6,132
16726,26,178,1358.74,2,3,3,8,233
16727,364,44,256.32,1,2,1,4,121
16728,46,263,1048.28,2,3,2,7,232
16729,38,656,7205.33,2,3,3,8,233
16730,52,82,743.11,2,3,2,7,232
16732,32,28,603.75,2,2,2,6,222
16734,52,52,646.76,2,2,2,6,222
16735,79,116,2247.41,2,3,3,8,233
16737,53,1,417.6,2,1,2,5,212
16738,298,1,3.75,1,1,1,3,111
16739,177,13,323,1,1,1,3,111
16742,47,1,464.9,2,1,2,5,212
16743,29,190,2213.13,2,3,3,8,233
16744,11,236,1291.91,3,3,3,9,333
16745,87,355,7180.7,2,3,3,8,233
16746,5,444,6680.11,3,3,3,9,333
16747,38,42,836.06,2,2,2,6,222
16748,18,69,1515.9,3,2,3,8,323
16750,45,95,623.93,2,3,2,7,232
16751,31,25,1764.72,2,2,3,7,223
16752,373,9,207.5,1,1,1,3,111
16753,58,34,223.92,2,2,1,5,221
16754,372,2,2002.4,1,1,3,5,113
16755,114,165,1475.43,1,3,3,7,133
16756,215,13,239.4,1,1,1,3,111
16757,319,7,106.83,1,1,1,3,111
16758,65,22,369.34,2,1,1,4,211
16759,8,42,789.79,3,2,2,7,322
16761,97,13,316.62,1,1,1,3,111
16762,20,63,1207.24,3,2,3,8,323
16763,199,23,611.85,1,1,2,4,112
16764,4,700,2790.95,3,3,3,9,333
16765,294,1,34,1,1,1,3,111
16766,273,34,1145.6,1,2,2,5,122
16767,31,221,5575.56,2,3,3,8,233
16768,48,54,478.09,2,2,2,6,222
16769,260,38,361.54,1,2,1,4,121
16770,58,140,757.1,2,3,2,7,232
16771,33,254,2242.61,2,3,3,8,233
16773,57,26,171.59,2,2,1,5,221
16774,68,48,661.52,2,2,2,6,222
16775,10,157,1691.51,3,3,3,9,333
16776,60,71,371.54,2,2,1,5,221
16777,80,48,222.62,2,2,1,5,221
16778,74,16,245.94,2,1,1,4,211
16779,2,331,10611.72,3,3,3,9,333
16780,100,59,422.24,1,2,2,5,122
16781,372,17,311.25,1,1,1,3,111
16782,10,183,2267.95,3,3,3,9,333
16784,20,3,107.6,3,1,1,5,311
16788,123,148,594.39,1,3,2,6,132
16789,8,5,80.8,3,1,1,5,311
16790,4,93,1545.62,3,3,3,9,333
16791,29,314,1705.78,2,3,3,8,233
16792,282,12,110.38,1,1,1,3,111
16793,57,16,243.84,2,1,1,4,211
16794,1,278,1196.5,3,3,3,9,333
16795,365,66,414.88,1,2,2,5,122
16796,89,18,305.62,2,1,1,4,211
16800,11,156,1162.65,3,3,2,8,332
16801,163,75,1594.23,1,3,3,7,133
16803,65,24,332.3,2,2,1,5,221
16804,23,60,536.99,3,2,2,7,322
16805,174,98,460.59,1,3,2,6,132
16806,103,93,762.16,1,3,2,6,132
16807,143,67,1121.59,1,2,2,5,122
16808,99,23,288.42,1,1,1,3,111
16809,23,149,914.69,3,3,2,8,332
16810,192,15,309.54,1,1,1,3,111
16811,5,28,547.07,3,2,2,7,322
16812,361,15,479.35,1,1,2,4,112
16813,8,426,1652.18,3,3,3,9,333
16814,14,319,6416.7,3,3,3,9,333
16816,103,28,417.06,1,2,2,5,122
16817,3,86,1604.75,3,3,3,9,333
16818,11,188,3349.57,3,3,3,9,333
16820,96,26,497.61,1,2,2,5,122
16823,227,38,358.38,1,2,1,4,121
16824,16,26,460.64,3,2,2,7,322
16825,39,28,775.18,2,2,2,6,222
16826,51,22,341.7,2,1,1,4,211
16828,93,8,128.5,1,1,1,3,111
16829,157,11,197.22,1,1,1,3,111
16830,39,23,325.91,2,1,1,4,211
16832,184,12,199.15,1,1,1,3,111
16833,1,47,1106.53,3,2,2,7,322
16834,228,24,413.46,1,2,2,5,122
16835,128,10,180.85,1,1,1,3,111
16836,40,11,251.87,2,1,1,4,211
16837,31,165,3170.98,2,3,3,8,233
16838,197,25,588.85,1,2,2,5,122
16839,9,266,16594.35,3,3,3,9,333
16841,37,116,1869.82,2,3,3,8,233
16842,101,63,1264.19,1,2,3,6,123
16843,43,378,10196.57,2,3,3,8,233
16846,50,11,214.32,2,1,1,4,211
16847,43,12,193.44,2,1,1,4,211
16848,53,14,281.42,2,1,1,4,211
16849,187,8,124.57,1,1,1,3,111
16850,334,19,332.41,1,1,1,3,111
16851,4,20,342.45,3,1,1,5,311
16852,10,9,144.91,3,1,1,5,311
16855,24,19,328.4,3,1,1,5,311
16856,15,2,35.4,3,1,1,5,311
16858,369,10,375.69,1,1,1,3,111
16859,145,52,747.81,1,2,2,5,122
16861,60,6,173.76,2,1,1,4,211
16863,31,26,502.8,2,2,2,6,222
16866,141,11,207.74,1,1,1,3,111
16869,23,127,817.12,3,3,2,8,332
16871,22,137,2812.34,3,3,3,9,333
16872,77,7,680.02,2,1,2,5,212
16873,5,279,7123.62,3,3,3,9,333
16875,67,112,2095.53,2,3,3,8,233
16877,12,156,846.62,3,3,2,8,332
16878,84,3,13.3,2,1,1,4,211
16880,31,174,1491.43,2,3,3,8,233
16881,67,1,432,2,1,2,5,212
16882,67,39,705.12,2,2,2,6,222
16883,187,37,272.48,1,2,1,4,121
16884,38,26,429.84,2,2,2,6,222
16885,15,96,450.41,3,3,2,8,332
16887,35,36,192.33,2,2,1,5,221
16889,195,135,1578.67,1,3,3,7,133
16891,2,186,742.43,3,3,2,8,332
16892,1,97,518.19,3,3,2,8,332
16893,367,45,145.93,1,2,1,4,121
16895,65,62,202.27,2,2,1,5,221
16897,299,37,289.78,1,2,1,4,121
16898,26,157,501.03,2,3,2,7,232
16899,8,123,1271.06,3,3,3,9,333
16900,17,79,887.11,3,3,2,8,332
16902,116,44,1706.88,1,2,3,6,123
16903,29,56,363.2,2,2,1,5,221
16904,4,665,3653.75,3,3,3,9,333
16905,5,199,3037.6,3,3,3,9,333
16906,82,86,559.59,2,3,2,7,232
16907,29,140,928.76,2,3,2,7,232
16909,72,18,379.14,2,1,1,4,211
16910,4,545,1508.96,3,3,3,9,333
16912,29,100,2555.58,2,3,3,8,233
16913,290,8,113.44,1,1,1,3,111
16914,36,30,183.76,2,2,1,5,221
16915,9,57,621.68,3,2,2,7,322
16916,24,136,562.41,3,3,2,8,332
16917,277,9,391.52,1,1,2,4,112
16918,50,128,1068.82,2,3,2,7,232
16919,156,326,2592.25,1,3,3,7,133
16921,61,55,154.18,2,2,1,5,221
16923,12,626,7069.08,3,3,3,9,333
16924,21,81,829.89,3,3,2,8,332
16926,371,14,230.25,1,1,1,3,111
16927,116,6,543.05,1,1,2,4,112
16928,80,204,2814.7,2,3,3,8,233
16929,4,77,1295.39,3,3,3,9,333
16930,26,53,378.89,2,2,1,5,221
16931,5,886,4554.87,3,3,3,9,333
16932,53,48,150.23,2,2,1,5,221
16933,1,44,563.23,3,2,2,7,322
16934,55,61,931.03,2,2,2,6,222
16936,26,56,261.9,2,2,1,5,221
16938,9,235,2711.68,3,3,3,9,333
16940,52,305,3049.88,2,3,3,8,233
16942,13,277,1904.99,3,3,3,9,333
16943,212,33,816.73,1,2,2,5,122
16945,22,249,4345.5,3,3,3,9,333
16947,236,21,406.48,1,1,2,4,112
16948,139,19,435.02,1,1,2,4,112
16949,4,60,1286.27,3,2,3,8,323
16950,57,42,1178.56,2,2,2,6,222
16951,135,86,1277.75,1,3,3,7,133
16952,109,16,167.61,1,1,1,3,111
16953,30,1,20.8,2,1,1,4,211
16954,1,54,2085.08,3,2,3,8,323
16955,185,25,518.67,1,2,2,5,122
16956,18,16,308.74,3,1,1,5,311
16957,239,16,416.64,1,1,2,4,112
16959,87,7,117.35,2,1,1,4,211
16960,39,101,507.05,2,3,2,7,232
16961,116,14,234.17,1,1,1,3,111
16963,187,7,110.55,1,1,1,3,111
16965,227,26,201.19,1,2,1,4,121
16966,8,28,2154.97,3,2,3,8,323
16967,189,21,319.02,1,1,1,3,111
16968,4,31,439.43,3,2,2,7,322
16969,39,42,650.41,2,2,2,6,222
16971,38,41,357.21,2,2,1,5,221
16976,267,2,251.52,1,1,1,3,111
16978,78,39,344.33,2,2,1,5,221
16979,4,89,1852,3,3,3,9,333
16980,255,81,1028.46,1,3,2,6,132
16982,61,22,384.06,2,1,1,4,211
16983,13,143,1905.87,3,3,3,9,333
16984,88,400,4459.52,2,3,3,8,233
16985,17,120,5464.12,3,3,3,9,333
16986,30,3,1873.2,2,1,3,6,213
16987,3,128,1616.8,3,3,3,9,333
16988,5,7,126.12,3,1,1,5,311
16989,7,12,1133.25,3,1,2,6,312
16990,219,1,179,1,1,1,3,111
16992,11,93,1614.31,3,3,3,9,333
16996,30,37,1456.96,2,2,3,7,223
16997,288,12,702,1,1,2,4,112
16998,150,4,295,1,1,1,3,111
16999,23,23,484.82,3,1,2,6,312
17001,1,169,3989.57,3,3,3,9,333
17002,86,49,1493.73,2,2,3,7,223
17004,46,43,1312.14,2,2,3,7,223
17006,5,44,781.78,3,2,2,7,322
17007,51,52,889.93,2,2,2,6,222
17010,18,11,195.36,3,1,1,5,311
17011,30,15,270.9,2,1,1,4,211
17014,8,72,583.43,3,2,2,7,322
17015,29,214,1838.61,2,3,3,8,233
17017,3,252,8694.26,3,3,3,9,333
17018,41,16,920.1,2,1,2,5,212
17019,11,228,1258.08,3,3,3,9,333
17022,31,7,71,2,1,1,4,211
17024,45,3,95.85,2,1,1,4,211
17025,61,9,357.77,2,1,1,4,211
17026,185,4,154.83,1,1,1,3,111
17027,79,148,877.56,2,3,2,7,232
17029,111,2,716,1,1,2,4,112
17030,64,11,146.87,2,1,1,4,211
17031,12,22,380.35,3,1,1,5,311
17033,86,28,1030.14,2,2,2,6,222
17034,16,30,745.52,3,2,2,7,322
17035,246,28,433.53,1,2,2,5,122
17037,88,75,1267.32,2,3,3,8,233
17038,30,22,112.4,2,1,1,4,211
17040,138,15,449.73,1,1,2,4,112
17041,27,69,1071.49,2,2,2,6,222
17042,3,97,1036.58,3,3,2,8,332
17043,32,102,1735.18,2,3,3,8,233
17044,25,6,948.48,3,1,2,6,312
17045,113,22,339.44,1,1,1,3,111
17046,157,22,642.02,1,1,2,4,112
17047,85,65,1100.9,2,2,2,6,222
17048,118,43,925.35,1,2,2,5,122
17049,3,317,5655.03,3,3,3,9,333
17050,96,308,3185.64,1,3,3,7,133
17051,194,42,240.89,1,2,1,4,121
17052,28,83,399.09,2,3,2,7,232
17053,131,13,498.48,1,1,2,4,112
17054,28,83,1356.33,2,3,3,8,233
17058,82,62,1179.89,2,2,2,6,222
17059,30,514,3080.39,2,3,3,8,233
17060,266,5,234.24,1,1,1,3,111
17061,74,99,5232.23,2,3,3,8,233
17062,314,69,533.33,1,2,2,5,122
17063,21,78,1461.14,3,3,3,9,333
17064,59,61,855.45,2,2,2,6,222
17068,12,296,4552.14,3,3,3,9,333
17069,28,143,2709.7,2,3,3,8,233
17070,114,62,304.24,1,2,1,4,121
17071,28,140,2429.03,2,3,3,8,233
17073,18,174,1446.09,3,3,3,9,333
17075,18,77,834.12,3,3,2,8,332
17076,36,25,841.08,2,2,2,6,222
17078,36,28,378.2,2,2,1,5,221
17079,78,2,118.8,2,1,1,4,211
17080,22,8,287.62,3,1,1,5,311
17081,25,63,288.91,3,2,1,6,321
17082,33,81,2003.85,2,3,3,8,233
17083,109,52,1405.78,1,2,3,6,123
17084,35,149,2747.99,2,3,3,8,233
17085,123,186,1562.4,1,3,3,7,133
17086,7,96,2050.08,3,3,3,9,333
17088,28,115,1991.01,2,3,3,8,233
17090,4,61,1974.65,3,2,3,8,323
17091,3,195,3827.76,3,3,3,9,333
17092,50,124,1774.03,2,3,3,8,233
17094,322,14,302,1,1,1,3,111
17095,23,74,1324.16,3,3,3,9,333
17096,15,48,1022.13,3,2,2,7,322
17097,2,211,954.42,3,3,2,8,332
17100,18,65,971.74,3,2,2,7,322
17101,10,42,1621.73,3,2,3,8,323
17102,262,1,25.5,1,1,1,3,111
17105,159,90,665.78,1,3,2,6,132
17107,33,416,10797.48,2,3,3,8,233
17109,29,116,881.29,2,3,2,7,232
17110,165,12,163.3,1,1,1,3,111
17111,47,29,231.61,2,2,1,5,221
17114,6,123,801.12,3,3,2,8,332
17115,8,39,837.5,3,2,2,7,322
17117,288,9,116.2,1,1,1,3,111
17118,318,10,157.02,1,1,1,3,111
17119,3,35,606.91,3,2,2,7,322
17120,233,18,307.46,1,1,1,3,111
17122,119,7,138.32,1,1,1,3,111
17123,162,9,345.3,1,1,1,3,111
17124,185,31,294.24,1,2,1,4,121
17125,50,35,230.5,2,2,1,5,221
17126,152,248,989.45,1,3,2,6,132
17128,335,14,157.09,1,1,1,3,111
17131,5,134,2463.17,3,3,3,9,333
17133,16,27,4892.24,3,2,3,8,323
17134,107,23,413.2,1,1,2,4,112
17135,16,52,1139.73,3,2,2,7,322
17138,276,24,380.5,1,2,1,4,121
17139,16,477,10650.77,3,3,3,9,333
17140,247,18,454.12,1,1,2,4,112
17142,239,15,579,1,1,2,4,112
17144,1,48,984.57,3,2,2,7,322
17146,106,35,749.78,1,2,2,5,122
17147,23,81,1714.59,3,3,3,9,333
17148,52,9,124.88,2,1,1,4,211
17152,195,14,1689.5,1,1,3,5,113
17153,24,14,213.78,3,1,1,5,311
17154,75,23,329.34,2,1,1,4,211
17155,18,20,251.7,3,1,1,5,311
17157,8,13,319,3,1,1,5,311
17158,32,67,1266.97,2,2,3,7,223
17159,22,101,1538.88,3,3,3,9,333
17160,31,229,3518.03,2,3,3,8,233
17162,29,104,1715.46,2,3,3,8,233
17163,22,5,293.1,3,1,1,5,311
17164,33,144,2467.35,2,3,3,8,233
17165,284,10,158.68,1,1,1,3,111
17166,39,12,206.34,2,1,1,4,211
17169,58,54,835.78,2,2,2,6,222
17171,289,16,224.91,1,1,1,3,111
17172,79,15,317.76,2,1,1,4,211
17173,5,86,3766.6,3,3,3,9,333
17174,218,4,59.9,1,1,1,3,111
17175,44,63,1443.69,2,2,3,7,223
17176,202,15,306.13,1,1,1,3,111
17179,178,80,711.79,1,3,2,6,132
17180,56,125,783.97,2,3,2,7,232
17181,57,23,239.92,2,1,1,4,211
17183,8,73,3347.31,3,3,3,9,333
17186,47,2,144,2,1,1,4,211
17187,227,10,203.95,1,1,1,3,111
17188,11,84,2474.23,3,3,3,9,333
17189,106,60,383.75,1,2,1,4,121
17190,59,19,444.74,2,1,2,5,212
17191,28,236,2093.68,2,3,3,8,233
17193,36,32,1699.3,2,2,3,7,223
17194,274,29,262.62,1,2,1,4,121
17197,30,29,1013.01,2,2,2,6,222
17198,24,96,692.22,3,3,2,8,332
17201,54,38,289.78,2,2,1,5,221
17203,36,148,3560.08,2,3,3,8,233
17204,175,57,1564.56,1,2,3,6,123
17205,54,13,384.08,2,1,1,4,211
17206,53,7,204.24,2,1,1,4,211
17211,27,211,2317.22,2,3,3,8,233
17212,253,4,226.85,1,1,1,3,111
17213,40,157,2781.23,2,3,3,8,233
17214,60,101,1059.12,2,3,2,7,232
17217,234,9,113.5,1,1,1,3,111
17218,4,271,1951.97,3,3,3,9,333
17219,32,25,114.23,2,2,1,5,221
17220,24,467,3187.55,3,3,3,9,333
17221,7,62,334.48,3,2,1,6,321
17222,65,27,328.65,2,2,1,5,221
17223,310,48,416.89,1,2,2,5,122
17226,309,21,393.49,1,1,2,4,112
17227,19,47,939.32,3,2,2,7,322
17228,16,208,1906.09,3,3,3,9,333
17229,96,47,318.76,1,2,1,4,121
17230,264,69,3638.41,1,2,3,6,123
17231,12,531,3124.72,3,3,3,9,333
17232,3,35,417.77,3,2,2,7,322
17233,35,25,190.88,2,2,1,5,221
17234,183,14,149.89,1,1,1,3,111
17235,25,29,550.06,3,2,2,7,322
17236,13,105,916.13,3,3,2,8,332
17237,11,19,314.69,3,1,1,5,311
17238,3,555,3719.1,3,3,3,9,333
17239,313,15,382.5,1,1,1,3,111
17242,108,40,1135.04,1,2,2,5,122
17243,1,387,8540.05,3,3,3,9,333
17244,53,31,954.9,2,2,2,6,222
17245,205,9,171.45,1,1,1,3,111
17247,15,54,280.09,3,2,1,6,321
17248,120,69,318.65,1,2,1,4,121
17250,4,56,381.97,3,2,1,6,321
17251,363,37,269.83,1,2,1,4,121
17252,117,86,348.91,1,3,1,5,131
17253,18,18,178.26,3,1,1,5,311
17254,5,111,271.19,3,3,1,7,331
17255,41,74,291.48,2,3,1,6,231
17256,107,16,240,1,1,1,3,111
17259,148,116,581.23,1,3,2,6,132
17262,52,12,1253.36,2,1,3,6,213
17263,208,23,63.44,1,1,1,3,111
17265,139,122,550.01,1,3,2,6,132
17266,2,73,296.58,3,3,1,7,331
17267,127,37,317.2,1,2,1,4,121
17268,108,6,763.64,1,1,2,4,112
17272,42,114,2148.63,2,3,3,8,233
17274,35,25,107.82,2,2,1,5,221
17277,228,69,1065.35,1,2,2,5,122
17278,241,15,246.04,1,1,1,3,111
17279,58,9,187.83,2,1,1,4,211
17282,130,89,1685.46,1,3,3,7,133
17284,60,291,1647.48,2,3,3,8,233
17286,22,44,151.37,3,2,1,6,321
17287,26,122,1049.06,2,3,2,7,232
17288,9,140,1417.63,3,3,3,9,333
17289,32,104,931.02,2,3,2,7,232
17290,4,96,513.01,3,3,2,8,332
17291,308,1,550.8,1,1,2,4,112
17293,8,132,1854.06,3,3,3,9,333
17295,29,68,547,2,2,2,6,222
17297,17,49,128.18,3,2,1,6,321
17298,101,30,498.42,1,2,2,5,122
17299,12,55,656.61,3,2,2,7,322
17301,21,59,163.24,3,2,1,6,321
17302,15,79,1135.63,3,3,2,8,332
17303,361,53,250.04,1,2,1,4,121
17306,11,66,8631.31,3,2,3,8,323
17309,95,12,82.75,1,1,1,3,111
17311,78,55,1384.85,2,2,3,7,223
17312,139,14,644.3,1,1,2,4,112
17313,31,24,2328.84,2,2,3,7,223
17314,25,131,2527.92,3,3,3,9,333
17315,2,471,6281.23,3,3,3,9,333
17317,46,9,2600.34,2,1,3,6,213
17320,100,73,1200.62,1,3,3,7,133
17321,8,99,657.16,3,3,2,8,332
17323,15,195,906.52,3,3,2,8,332
17324,18,49,986.48,3,2,2,7,322
17325,280,6,96.8,1,1,1,3,111
17329,14,33,523.11,3,2,2,7,322
17330,23,6,363.9,3,1,1,5,311
17331,124,1,175.2,1,1,1,3,111
17333,86,28,494.25,2,2,2,6,222
17334,302,11,307.02,1,1,1,3,111
17337,151,521,1981.06,1,3,3,7,133
17338,17,721,6493.54,3,3,3,9,333
17339,94,9,243.36,1,1,1,3,111
17340,30,407,12353.29,2,3,3,8,233
17341,157,157,682.29,1,3,2,6,132
17343,355,17,193.64,1,1,1,3,111
17344,46,31,157.62,2,2,1,5,221
17345,15,83,519.69,3,3,2,8,332
17346,4,483,2622.88,3,3,3,9,333
17347,86,1,228.96,2,1,1,4,211
17348,15,213,1156.6,3,3,2,8,332
17349,179,8,98.25,1,1,1,3,111
17350,8,70,1281.32,3,2,3,8,323
17351,36,27,587.15,2,2,2,6,222
17353,129,8,1740,1,1,3,5,113
17354,51,16,1393.06,2,1,3,6,213
17356,312,19,178.22,1,1,1,3,111
17357,24,44,384.39,3,2,1,6,321
17358,303,58,360.81,1,2,1,4,121
17359,11,15,127.86,3,1,1,5,311
17360,17,125,568.24,3,3,2,8,332
17361,49,29,488.2,2,2,2,6,222
17362,239,35,312.23,1,2,1,4,121
17364,1,406,4462.68,3,3,3,9,333
17365,13,465,4767.36,3,3,3,9,333
17367,238,33,167.55,1,2,1,4,121
17368,23,107,1878.87,3,3,3,9,333
17370,73,33,446.18,2,2,2,6,222
17371,17,86,418.4,3,3,2,8,332
17372,41,251,1337.18,2,3,3,8,233
17373,40,57,646.92,2,2,2,6,222
17374,219,28,495.77,1,2,2,5,122
17375,199,69,400.1,1,2,2,5,122
17376,71,24,203.2,2,2,1,5,221
17377,24,404,4058.32,3,3,3,9,333
17379,11,78,389.72,3,3,2,8,332
17381,9,109,20275.61,3,3,3,9,333
17382,65,2,65.4,2,1,1,4,211
17383,4,49,193.39,3,2,1,6,321
17384,19,15,336.4,3,1,1,5,311
17385,15,45,256.11,3,2,1,6,321
17386,8,28,2686.42,3,2,3,8,323
17387,20,76,746.81,3,3,2,8,332
17388,78,15,1259.56,2,1,3,6,213
17389,1,213,31833.68,3,3,3,9,333
17391,164,3,508.8,1,1,2,4,112
17392,307,56,417.27,1,2,2,5,122
17394,219,4,203.87,1,1,1,3,111
17396,39,27,7330.8,2,2,3,7,223
17397,22,89,681.41,3,3,2,8,332
17398,115,38,653.38,1,2,2,5,122
17400,126,206,2097.84,1,3,3,7,133
17402,5,59,2633.85,3,2,3,8,323
17403,36,32,263.92,2,2,1,5,221
17404,4,198,31906.82,3,3,3,9,333
17405,1,82,1031.41,3,3,2,8,332
17406,333,111,2184.42,1,3,3,7,133
17408,163,2,32.65,1,1,1,3,111
17409,185,13,771.85,1,1,2,4,112
17410,16,64,1214.72,3,2,3,8,323
17411,12,41,778.94,3,2,2,7,322
17412,3,66,1258.06,3,2,3,8,323
17414,44,6,778,2,1,2,5,212
17415,80,14,507.84,2,1,2,5,212
17416,30,269,6893.42,2,3,3,8,233
17418,42,30,463.46,2,2,2,6,222
17419,11,206,4226.57,3,3,3,9,333
17420,50,30,598.83,2,2,2,6,222
17422,16,117,1979.37,3,3,3,9,333
17423,46,26,698.41,2,2,2,6,222
17425,19,43,759.17,3,2,2,7,322
17426,8,271,5037.26,3,3,3,9,333
17427,72,2,100.8,2,1,1,4,211
17428,1,328,17256.85,3,3,3,9,333
17429,128,39,524.92,1,2,2,5,122
17430,33,14,265.76,2,1,1,4,211
17431,313,43,403.3,1,2,2,5,122
17432,18,48,365.76,3,2,1,6,321
17433,88,54,303.16,2,2,1,5,221
17434,2,134,2373.82,3,3,3,9,333
17436,2,9,216.3,3,1,1,5,311
17438,254,17,388.45,1,1,2,4,112
17440,157,5,186.42,1,1,1,3,111
17442,37,135,2248.56,2,3,3,8,233
17443,220,1,534.24,1,1,2,4,112
17444,148,135,2940.04,1,3,3,7,133
17446,177,9,120.9,1,1,1,3,111
17447,40,36,541.53,2,2,2,6,222
17449,2,276,2519.21,3,3,3,9,333
17450,8,336,194390.79,3,3,3,9,333
17451,1,100,1721.4,3,3,3,9,333
17453,18,19,486.72,3,1,2,6,312
17454,192,61,517.53,1,2,2,5,122
17455,204,8,131.7,1,1,1,3,111
17456,365,17,249.86,1,1,1,3,111
17457,127,19,1737.7,1,1,3,5,113
17458,15,54,316.5,3,2,1,6,321
17459,43,111,657.3,2,3,2,7,232
17460,94,29,622.43,1,2,2,5,122
17461,23,106,735.82,3,3,2,8,332
17462,60,27,675.69,2,2,2,6,222
17463,16,208,1875.86,3,3,3,9,333
17464,158,9,289.96,1,1,1,3,111
17466,10,41,763.28,3,2,2,7,322
17468,10,5,137,3,1,1,5,311
17469,16,88,1870.97,3,3,3,9,333
17470,45,78,1125.07,2,3,2,7,232
17472,191,174,697.54,1,3,2,6,132
17475,79,14,194.37,2,1,1,4,211
17480,78,29,511.82,2,2,2,6,222
17481,4,82,1255.59,3,3,3,9,333
17483,65,21,414.04,2,1,2,5,212
17486,261,24,396.87,1,2,2,5,122
17489,59,29,376.64,2,2,1,5,221
17490,1,76,2092.32,3,3,3,9,333
17491,1,109,3558.87,3,3,3,9,333
17492,248,12,374.57,1,1,1,3,111
17495,8,27,497.56,3,2,2,7,322
17496,359,10,271.05,1,1,1,3,111
17498,76,17,272.22,2,1,1,4,211
17499,290,40,622.88,1,2,2,5,122
17500,17,5,1138,3,1,2,6,312
17501,221,18,288.6,1,1,1,3,111
17502,9,28,689.1,3,2,2,7,322
17503,3,38,558.96,3,2,2,7,322
17504,206,127,2997.03,1,3,3,7,133
17505,162,52,1145.84,1,2,2,5,122
17506,76,14,302.2,2,1,1,4,211
17507,262,88,605.58,1,3,2,6,132
17508,281,22,387.31,1,1,1,3,111
17509,58,364,6083.64,2,3,3,8,233
17510,25,20,308.48,3,1,1,5,311
17511,3,963,91062.38,3,3,3,9,333
17512,29,105,2924.99,2,3,3,8,233
17513,72,6,513.2,2,1,2,5,212
17514,128,40,208.65,1,2,1,4,121
17515,31,87,639.02,2,3,2,7,232
17516,15,135,764.88,3,3,2,8,332
17517,309,11,153.94,1,1,1,3,111
17519,17,82,1844.02,3,3,3,9,333
17520,54,30,546.81,2,2,2,6,222
17521,30,45,723.21,2,2,2,6,222
17522,2,73,1070.71,3,3,2,8,332
17523,11,33,652.74,3,2,2,7,322
17524,361,6,145,1,1,1,3,111
17525,360,9,422.7,1,1,2,4,112
17526,5,19,1195.9,3,1,3,7,313
17527,54,47,939.37,2,2,2,6,222
17528,1,253,3628.5,3,3,3,9,333
17530,1,390,2367.12,3,3,3,9,333
17531,190,14,296.7,1,1,1,3,111
17534,54,9,223.36,2,1,1,4,211
17535,280,13,164.4,1,1,1,3,111
17536,177,3,76.5,1,1,1,3,111
17537,30,74,887.67,2,3,2,7,232
17538,26,9,98.42,2,1,1,4,211
17540,25,25,578.9,3,2,2,7,322
17542,270,25,170.75,1,2,1,4,121
17545,43,141,642.32,2,3,2,7,232
17548,234,5,103.3,1,1,1,3,111
17549,24,6,148.86,3,1,1,5,311
17550,197,42,267.16,1,2,1,4,121
17551,359,39,290.34,1,2,1,4,121
17552,60,49,930.41,2,2,2,6,222
17553,130,2,1487.6,1,1,3,5,113
17554,1,88,1952.45,3,3,3,9,333
17555,20,105,480.31,3,3,2,8,332
17556,206,6,157.9,1,1,1,3,111
17557,14,34,541.46,3,2,2,7,322
17560,95,26,854.95,1,2,2,5,122
17561,19,45,165.12,3,2,1,6,321
17562,14,63,1122.38,3,2,2,7,322
17564,24,49,454.01,3,2,2,7,322
17566,8,142,869.77,3,3,2,8,332
17567,7,165,4331.48,3,3,3,9,333
17569,332,29,344.14,1,2,1,4,121
17571,50,271,1425.67,2,3,3,8,233
17572,71,12,226.75,2,1,1,4,211
17573,29,25,380.6,2,2,1,5,221
17574,243,8,185.65,1,1,1,3,111
17576,8,402,3564.83,3,3,3,9,333
17578,218,5,143.46,1,1,1,3,111
17579,5,50,448.9,3,2,2,7,322
17580,253,45,215.72,1,2,1,4,121
17581,1,439,11025.24,3,3,3,9,333
17582,236,29,175.27,1,2,1,4,121
17584,7,35,1242.3,3,2,3,8,323
17585,109,208,1116.68,1,3,2,6,132
17588,100,23,1240.2,1,1,3,5,113
17589,60,253,2404.17,2,3,3,8,233
17590,2,196,1468.02,3,3,3,9,333
17591,73,157,2203.67,2,3,3,8,233
17593,4,212,3923.86,3,3,3,9,333
17594,85,50,993.18,2,2,2,6,222
17595,12,82,386.69,3,3,1,7,331
17596,23,265,2806.69,3,3,3,9,333
17597,214,55,2044.37,1,2,3,6,123
17600,18,13,161.67,3,1,1,5,311
17601,239,9,116.01,1,1,1,3,111
17602,2,551,5054.42,3,3,3,9,333
17603,78,11,394.72,2,1,2,5,212
17604,217,63,309.36,1,2,1,4,121
17608,33,56,191.99,2,2,1,5,221
17609,41,233,1105.78,2,3,2,7,232
17611,7,567,3961.12,3,3,3,9,333
17612,53,135,2048.45,2,3,3,8,233
17613,23,306,4544.55,3,3,3,9,333
17614,57,98,386.32,2,3,1,6,231
17615,130,14,329.6,1,1,1,3,111
17616,174,3,571.2,1,1,2,4,112
17618,6,67,930.28,3,2,2,7,322
17619,312,74,214.37,1,3,1,5,131
17620,60,4,81.44,2,1,1,4,211
17621,21,26,1379.9,3,2,3,8,323
17623,33,33,527.05,2,2,2,6,222
17624,15,50,843.48,3,2,2,7,322
17625,18,306,2020.4,3,3,3,9,333
17628,81,5,75.75,2,1,1,4,211
17629,6,123,1814.12,3,3,3,9,333
17630,170,26,503.6,1,2,2,5,122
17631,2,39,528.33,3,2,2,7,322
17633,31,70,1324.84,2,2,3,7,223
17634,36,296,2358.59,2,3,3,8,233
17636,19,20,285.56,3,1,1,5,311
17637,31,35,547.06,2,2,2,6,222
17639,276,7,108.5,1,1,1,3,111
17640,87,5,621.66,2,1,2,5,212
17642,120,40,712.29,1,2,2,5,122
17643,373,8,101.55,1,1,1,3,111
17644,1,157,2895.64,3,3,3,9,333
17646,219,51,1008.39,1,2,2,5,122
17647,65,7,133.06,2,1,1,4,211
17648,61,91,1797.5,2,3,3,8,233
17649,138,52,868.49,1,2,2,5,122
17650,21,8,166.08,3,1,1,5,311
17651,12,232,3945,3,3,3,9,333
17652,25,259,4867.72,3,3,3,9,333
17653,37,44,1207.56,2,2,3,7,223
17654,277,22,117.55,1,1,1,3,111
17655,11,91,2638.94,3,3,3,9,333
17656,73,82,1674.69,2,3,3,8,233
17658,26,19,595.42,2,1,2,5,212
17659,17,158,2999.46,3,3,3,9,333
17660,141,38,178.75,1,2,1,4,121
17663,26,86,1802.91,2,3,3,8,233
17664,19,43,604.64,3,2,2,7,322
17666,4,18,728.16,3,1,2,6,312
17667,66,116,2055.51,2,3,3,8,233
17668,1,15,347.75,3,1,1,5,311
17669,43,68,3406.72,2,2,3,7,223
17670,228,11,205.7,1,1,1,3,111
17671,16,53,1572.71,3,2,3,8,323
17672,50,110,3178.17,2,3,3,8,233
17673,2,218,1594.97,3,3,3,9,333
17674,74,27,551.04,2,2,2,6,222
17675,1,705,20374.28,3,3,3,9,333
17676,4,77,1371.18,3,3,3,9,333
17677,2,303,16345.38,3,3,3,9,333
17678,264,16,298.11,1,1,1,3,111
17679,53,30,1992.11,2,2,3,7,223
17680,24,11,184.4,3,1,1,5,311
17682,10,118,2474.33,3,3,3,9,333
17684,44,15,239.41,2,1,1,4,211
17685,17,127,3155.83,3,3,3,9,333
17686,7,286,5739.46,3,3,3,9,333
17690,30,252,4726.8,2,3,3,8,233
17691,358,19,290.4,1,1,1,3,111
17692,127,46,740.94,1,2,2,5,122
17693,137,16,200.47,1,1,1,3,111
17694,142,15,283.12,1,1,1,3,111
17695,132,35,765.34,1,2,2,5,122
17696,38,115,2285.71,2,3,3,8,233
17697,236,19,338.95,1,1,1,3,111
17698,261,8,154.95,1,1,1,3,111
17700,17,142,2534.64,3,3,3,9,333
17701,253,24,417.95,1,2,2,5,122
17702,30,74,1824.37,2,3,3,8,233
17703,35,55,798.74,2,2,2,6,222
17704,169,31,885.19,1,2,2,5,122
17705,3,103,1823.52,3,3,3,9,333
17706,4,382,10504.49,3,3,3,9,333
17707,185,5,152.4,1,1,1,3,111
17708,188,34,263.33,1,2,1,4,121
17709,170,7,137.45,1,1,1,3,111
17711,11,23,385.1,3,1,1,5,311
17712,45,29,522.91,2,2,2,6,222
17714,321,10,153,1,1,1,3,111
17715,201,1,326.4,1,1,1,3,111
17716,23,245,5655.99,3,3,3,9,333
17718,232,6,139.35,1,1,1,3,111
17719,38,274,5396.04,2,3,3,8,233
17720,26,50,1195.94,2,2,3,7,223
17722,96,115,2424.04,1,3,3,7,133
17723,127,10,3276.4,1,1,3,5,113
17724,71,40,1033,2,2,2,6,222
17725,16,192,3439.08,3,3,3,9,333
17727,15,66,1060.25,3,2,2,7,322
17728,4,165,2876.01,3,3,3,9,333
17730,3,218,5298.48,3,3,3,9,333
17731,79,67,1240.11,2,2,3,7,223
17732,373,18,303.97,1,1,1,3,111
17733,39,35,692.19,2,2,2,6,222
17734,54,43,700.63,2,2,2,6,222
17735,2,690,13110.02,3,3,3,9,333
17736,9,25,377.44,3,2,1,6,321
17737,9,10,168.24,3,1,1,5,311
17738,19,97,1879.05,3,3,3,9,333
17739,12,47,2791.35,3,2,3,8,323
17742,113,15,355.11,1,1,1,3,111
17744,4,136,2322.4,3,3,3,9,333
17746,240,6,110.25,1,1,1,3,111
17747,113,1,71.4,1,1,1,3,111
17749,178,35,674.52,1,2,2,5,122
17750,5,184,1710.45,3,3,3,9,333
17752,359,1,80.64,1,1,1,3,111
17754,1,89,1664.65,3,3,3,9,333
17757,1,740,5593.39,3,3,3,9,333
17758,19,404,3408.2,3,3,3,9,333
17759,17,90,819.96,3,3,2,8,332
17760,22,25,287.59,3,2,1,6,321
17761,33,19,712.78,2,1,2,5,212
17763,263,1,15,1,1,1,3,111
17764,51,71,772.55,2,2,2,6,222
17765,159,56,367.63,1,2,1,4,121
17767,15,21,271.2,3,1,1,5,311
17768,8,98,2081.9,3,3,3,9,333
17769,13,304,3957.43,3,3,3,9,333
17770,199,38,1143.27,1,2,2,5,122
17771,57,54,245.81,2,2,1,5,221
17772,11,50,173.45,3,2,1,6,321
17774,97,153,1213.73,1,3,3,7,133
17775,255,3,56.4,1,1,1,3,111
17777,25,190,647.56,3,3,2,8,332
17779,21,81,650.32,3,3,2,8,332
17781,159,12,188.02,1,1,1,3,111
17783,72,67,283.47,2,2,1,5,221
17785,53,13,131.94,2,1,1,4,211
17786,85,68,266.85,2,2,1,5,221
17787,153,128,1817.54,1,3,3,7,133
17788,74,5,1117.9,2,1,2,5,212
17789,281,14,225.9,1,1,1,3,111
17790,27,189,1964.3,2,3,3,8,233
17791,30,10,106.1,2,1,1,4,211
17793,25,52,300.34,3,2,1,6,321
17795,180,45,342.83,1,2,1,4,121
17796,40,81,690,2,3,2,7,232
17797,22,111,780.43,3,3,2,8,332
17799,22,404,3039.17,3,3,3,9,333
17800,37,103,1187.21,2,3,2,7,232
17802,82,140,1285.04,2,3,3,8,233
17805,74,10,512.31,2,1,2,5,212
17806,11,43,546.04,3,2,2,7,322
17809,16,61,5411.91,3,2,3,8,323
17811,4,828,7761.82,3,3,3,9,333
17812,13,133,699.81,3,3,2,8,332
17813,14,348,1698.07,3,3,3,9,333
17816,37,17,36.56,2,1,1,4,211
17817,4,33,387.68,3,2,1,6,321
17819,72,48,3704.87,2,2,3,7,223
17824,51,13,298.4,2,1,1,4,211
17827,5,215,1987.33,3,3,3,9,333
17828,23,67,1820.09,3,2,3,8,323
17829,299,30,889.24,1,2,2,5,122
17830,2,23,398.7,3,1,2,6,312
17831,33,2,35.4,2,1,1,4,211
17832,50,61,155.37,2,2,1,5,221
17835,3,59,342.24,3,2,1,6,321
17836,47,24,110.21,2,2,1,5,221
17837,42,162,1541.23,2,3,3,8,233
17838,27,117,2720.8,2,3,3,8,233
17839,42,52,318.15,2,2,1,5,221
17841,2,7676,40519.84,3,3,3,9,333
17843,303,37,205.48,1,2,1,4,121
17844,107,5,51.56,1,1,1,3,111
17846,85,1,2033.1,2,1,3,6,213
17848,81,51,901.2,2,2,2,6,222
17849,218,26,605.8,1,2,2,5,122
17850,372,297,5391.21,1,3,3,7,133
17852,12,24,114.34,3,2,1,6,321
17854,185,15,311.26,1,1,1,3,111
17855,373,17,208.97,1,1,1,3,111
17856,2,15,1418.03,3,1,3,7,313
17857,4,54,26879.04,3,2,3,8,323
17858,6,197,5140.66,3,3,3,9,333
17859,305,23,141.92,1,1,1,3,111
17860,369,52,226.45,1,2,1,4,121
17861,3,219,2097.88,3,3,3,9,333
17862,324,11,330.9,1,1,1,3,111
17863,59,148,3160,2,3,3,8,233
17864,13,90,554.85,3,3,2,8,332
17865,31,370,10526.32,2,3,3,8,233
17866,143,9,329.65,1,1,1,3,111
17867,30,68,1157.87,2,2,2,6,222
17869,107,40,428.18,1,2,2,5,122
17870,2,270,1865.89,3,3,3,9,333
17871,205,10,155.9,1,1,1,3,111
17873,80,43,1848.96,2,2,3,7,223
17874,185,46,683.46,1,2,2,5,122
17877,170,12,237.61,1,1,1,3,111
17878,44,26,379.45,2,2,1,5,221
17879,174,6,178.52,1,1,1,3,111
17880,365,26,458.92,1,2,2,5,122
17881,304,8,133.35,1,1,1,3,111
17883,3,142,664.34,3,3,2,8,332
17884,4,113,695.07,3,3,2,8,332
17885,12,53,156.34,3,2,1,6,321
17886,32,102,869.28,2,3,2,7,232
17887,129,10,111.35,1,1,1,3,111
17888,21,65,716,3,2,2,7,322
17889,212,20,201.37,1,1,1,3,111
17890,323,91,586.89,1,3,2,6,132
17891,162,34,203.86,1,2,1,4,121
17892,56,28,244.1,2,2,1,5,221
17893,225,15,107.21,1,1,1,3,111
17894,72,192,1118.96,2,3,2,7,232
17895,44,15,95.45,2,1,1,4,211
17896,23,2,256.32,3,1,1,5,311
17897,173,108,541.81,1,3,2,6,132
17898,85,28,152.06,2,2,1,5,221
17899,159,31,154.55,1,2,1,4,121
17900,190,6,112.2,1,1,1,3,111
17901,29,19,110.38,2,1,1,4,211
17904,21,34,181.07,3,2,1,6,321
17905,71,33,798.99,2,2,2,6,222
17906,247,12,72.9,1,1,1,3,111
17908,374,54,232.03,1,2,1,4,121
17911,9,39,366.23,3,2,1,6,321
17912,310,37,310.06,1,2,1,4,121
17913,59,58,408.65,2,2,2,6,222
17914,4,75,329.36,3,3,1,7,331
17917,45,92,335.03,2,3,1,6,231
17919,88,23,1304.04,2,1,3,6,213
17920,4,665,4119.5,3,3,3,9,333
17921,64,142,820.23,2,3,2,7,232
17923,282,1,207.5,1,1,1,3,111
17924,12,31,2962.5,3,2,3,8,323
17925,373,1,244.08,1,1,1,3,111
17926,133,21,397.29,1,1,2,4,112
17928,45,23,212.54,2,1,1,4,211
17929,11,5,843,3,1,2,6,312
17930,36,39,1740.48,2,2,3,7,223
17931,134,65,408.36,1,2,2,5,122
17932,29,90,1331.57,2,3,3,8,233
17934,52,21,704.25,2,1,2,5,212
17935,138,29,145.79,1,2,1,4,121
17936,5,72,380.13,3,2,1,6,321
17937,9,43,4301.22,3,2,3,8,323
17939,160,12,99.14,1,1,1,3,111
17940,49,18,4020.04,2,1,3,6,213
17941,131,2,304.56,1,1,1,3,111
17942,8,2,77.5,3,1,1,5,311
17946,233,20,149.58,1,1,1,3,111
17947,37,9,176.68,2,1,1,4,211
17948,147,1,358.56,1,1,1,3,111
17949,1,70,58510.48,3,2,3,8,323
17950,72,71,482.2,2,2,2,6,222
17951,40,20,1008.54,2,1,2,5,212
17954,5,477,2314.13,3,3,3,9,333
17955,199,19,557.3,1,1,2,4,112
17956,249,1,12.75,1,1,1,3,111
17957,66,31,111.68,2,2,1,5,221
17958,117,7,508.46,1,1,2,4,112
17960,171,26,73.78,1,2,1,4,121
17961,21,249,1296.44,3,3,3,9,333
17962,142,34,102.41,1,2,1,4,121
17964,32,98,463.21,2,3,2,7,232
17965,38,325,2599.19,2,3,3,8,233
17966,38,68,1098.43,2,2,2,6,222
17967,372,42,112.27,1,2,1,4,121
17968,374,81,265.1,1,3,1,5,131
17969,166,14,228.2,1,1,1,3,111
17970,211,29,562.79,1,2,2,5,122
17972,242,30,135.19,1,2,1,4,121
17973,52,15,337.04,2,1,1,4,211
17974,25,165,703.99,3,3,2,8,332
17975,15,293,4483.26,3,3,3,9,333
17976,372,57,321.79,1,2,1,4,121
17977,29,21,288.14,2,1,1,4,211
17978,365,12,300.92,1,1,1,3,111
17979,36,138,732.41,2,3,2,7,232
17980,166,30,811.45,1,2,2,5,122
17984,145,48,152.68,1,2,1,4,121
17985,22,21,631.35,3,1,2,6,312
17986,56,1,20.8,2,1,1,4,211
17987,185,13,198.57,1,1,1,3,111
17988,12,38,201.12,3,2,1,6,321
17990,237,29,630.84,1,2,2,5,122
17991,225,5,93.35,1,1,1,3,111
17994,122,79,674.89,1,3,2,6,132
17995,282,2,76.1,1,1,1,3,111
17997,74,164,1962.46,2,3,3,8,233
17999,37,91,380.39,2,3,1,6,231
18001,12,57,415.13,3,2,2,7,322
18004,362,37,157.92,1,2,1,4,121
18005,4,53,226.47,3,2,1,6,321
18006,23,22,444.68,3,1,2,6,312
18008,70,30,2116.19,2,2,3,7,223
18009,235,31,247.39,1,2,1,4,121
18010,257,14,174.8,1,1,1,3,111
18011,373,28,102.79,1,2,1,4,121
18013,155,31,187.29,1,2,1,4,121
18014,28,30,162.22,2,2,1,5,221
18015,4,46,120.03,3,2,1,6,321
18016,32,122,1477.66,2,3,3,8,233
18017,81,3,523,2,1,2,5,212
18018,108,29,122.14,1,2,1,4,121
18019,52,5,38.45,2,1,1,4,211
18022,36,164,612.72,2,3,2,7,232
18024,153,21,389.78,1,1,2,4,112
18027,99,21,115.31,1,1,1,3,111
18030,4,9,230.65,3,1,1,5,311
18032,334,5,73.5,1,1,1,3,111
18033,65,33,93.82,2,2,1,5,221
18034,22,110,418.68,3,3,2,8,332
18035,36,49,713.89,2,2,2,6,222
18036,32,94,403.12,2,3,2,7,232
18037,154,19,70.02,1,1,1,3,111
18040,19,19,357.2,3,1,1,5,311
18041,12,458,4097.37,3,3,3,9,333
18042,54,7,165.05,2,1,1,4,211
18043,25,115,529.29,3,3,2,8,332
18044,4,127,2088.6,3,3,3,9,333
18045,45,43,178.34,2,2,1,5,221
18048,203,7,172.29,1,1,1,3,111
18050,359,5,74.4,1,1,1,3,111
18053,71,20,300.02,2,1,1,4,211
18055,7,358,6761.34,3,3,3,9,333
18056,288,19,363.65,1,1,1,3,111
18058,10,3,170.16,3,1,1,5,311
18059,23,18,306.46,3,1,1,5,311
18061,22,46,2119.41,3,2,3,8,323
18062,173,27,720.52,1,2,2,5,122
18064,133,7,814,1,1,2,4,112
18065,6,137,2392.83,3,3,3,9,333
18066,75,10,318,2,1,1,4,211
18067,40,37,396.33,2,2,2,6,222
18068,289,1,101.7,1,1,1,3,111
18069,26,457,2009.24,2,3,3,8,233
18071,258,25,453,1,2,2,5,122
18072,186,18,247.44,1,1,1,3,111
18073,114,72,3859.82,1,2,3,6,123
18074,374,13,489.6,1,1,2,4,112
18075,23,142,2611.75,3,3,3,9,333
18077,8,223,2584.41,3,3,3,9,333
18078,217,29,336.13,1,2,1,4,121
18079,45,123,3613.15,2,3,3,8,233
18080,19,2,1231.5,3,1,3,7,313
18081,36,17,343.45,2,1,1,4,211
18082,26,70,680.84,2,2,2,6,222
18084,16,1,90.48,3,1,1,5,311
18085,330,29,689.95,1,2,2,5,122
18086,274,7,101.34,1,1,1,3,111
18087,98,2,4055.72,1,1,3,5,113
18088,61,37,166.03,2,2,1,5,221
18092,2,89,9068.26,3,3,3,9,333
18093,93,36,2106.52,1,2,3,6,123
18094,82,70,3017.3,2,2,3,7,223
18095,313,21,580.05,1,1,2,4,112
18096,12,196,849.06,3,3,2,8,332
18097,8,106,2662.4,3,3,3,9,333
18099,127,19,168.31,1,1,1,3,111
18101,11,40,222.4,3,2,1,6,321
18102,1,431,259657.3,3,3,3,9,333
18104,37,38,754.64,2,2,2,6,222
18105,38,18,113.48,2,1,1,4,211
18106,330,37,421.9,1,2,2,5,122
18108,254,17,271,1,1,1,3,111
18109,2,441,8004.92,3,3,3,9,333
18110,20,37,198.8,3,2,1,6,321
18112,12,26,352.69,3,2,1,6,321
18113,369,1,76.32,1,1,1,3,111
18114,290,28,220.1,1,2,1,4,121
18116,68,371,1403.11,2,3,3,8,233
18117,26,72,315.65,2,2,1,5,221
18118,11,1263,5625.08,3,3,3,9,333
18119,368,29,180.7,1,2,1,4,121
18120,214,17,111.15,1,1,1,3,111
18121,149,31,653.3,1,2,2,5,122
18122,8,357,1793.06,3,3,3,9,333
18123,24,34,574.44,3,2,2,7,322
18125,30,192,1131.75,2,3,2,7,232
18126,61,52,200.92,2,2,1,5,221
18127,19,46,347.08,3,2,1,6,321
18129,243,14,112.55,1,1,1,3,111
18130,15,70,1059.39,3,2,2,7,322
18133,212,1,931.5,1,1,2,4,112
18135,29,20,681.91,2,1,2,5,212
18136,63,38,784.33,2,2,2,6,222
18138,295,8,152.65,1,1,1,3,111
18139,18,159,8438.34,3,3,3,9,333
18142,157,15,1019.52,1,1,2,4,112
18143,117,61,1000.16,1,2,2,5,122
18144,8,43,2888.75,3,2,3,8,323
18145,13,221,2861.55,3,3,3,9,333
18146,141,10,160.35,1,1,1,3,111
18147,46,7,179.34,2,1,1,4,211
18149,51,16,612.08,2,1,2,5,212
18150,32,37,566.58,2,2,2,6,222
18151,135,38,653.35,1,2,2,5,122
18154,3,21,399.19,3,1,2,6,312
18155,75,25,371.62,2,2,1,5,221
18156,13,122,675.64,3,3,2,8,332
18158,9,34,453.4,3,2,2,7,322
18159,301,23,530.15,1,1,2,4,112
18160,57,39,638.06,2,2,2,6,222
18161,15,80,1618.69,3,3,3,9,333
18164,37,24,399.65,2,2,2,6,222
18165,177,10,302.46,1,1,1,3,111
18167,23,37,1384.86,3,2,3,8,323
18168,176,130,1160.04,1,3,2,6,132
18169,61,9,202.65,2,1,1,4,211
18170,33,38,980.31,2,2,2,6,222
18171,59,54,1231.31,2,2,3,7,223
18172,15,189,7561.68,3,3,3,9,333
18173,87,31,2106.84,2,2,3,7,223
18174,7,1,104,3,1,1,5,311
18176,358,30,476.35,1,2,2,5,122
18177,31,73,1340.87,2,3,3,8,233
18178,129,97,1590.81,1,3,3,7,133
18179,9,90,1793.17,3,3,3,9,333
18180,5,119,1843.75,3,3,3,9,333
18181,24,41,366.85,3,2,1,6,321
18183,227,37,632.07,1,2,2,5,122
18184,15,1,49.8,3,1,1,5,311
18185,249,17,304.25,1,1,1,3,111
18188,15,71,2001.04,3,2,3,8,323
18189,78,68,1090.24,2,2,2,6,222
18190,192,15,284.46,1,1,1,3,111
18191,262,7,207.8,1,1,1,3,111
18192,72,45,957.97,2,2,2,6,222
18193,165,16,243.76,1,1,1,3,111
18194,82,7,973.84,2,1,2,5,212
18196,95,139,686.63,1,3,2,6,132
18198,4,159,5425.56,3,3,3,9,333
18200,106,30,150.35,1,2,1,4,121
18202,200,68,1396.99,1,2,3,6,123
18203,157,19,160.42,1,1,1,3,111
18204,71,192,1975.35,2,3,3,8,233
18205,36,32,517.36,2,2,2,6,222
18209,29,8,139.1,2,1,1,4,211
18210,2,134,2621.38,3,3,3,9,333
18211,26,42,600.07,2,2,2,6,222
18212,326,34,216.07,1,2,1,4,121
18213,237,15,232.48,1,1,1,3,111
18215,89,13,299.34,2,1,1,4,211
18216,31,26,481.75,2,2,2,6,222
18217,29,31,621.75,2,2,2,6,222
18218,211,20,641.92,1,1,2,4,112
18219,3,114,2069.77,3,3,3,9,333
18220,227,2,305.28,1,1,1,3,111
18221,22,64,1041.61,3,2,2,7,322
18222,93,19,443,1,1,2,4,112
18223,5,272,6484.54,3,3,3,9,333
18224,264,10,158.95,1,1,1,3,111
18225,3,269,5504.96,3,3,3,9,333
18226,44,242,5228.05,2,3,3,8,233
18227,218,5,93.75,1,1,1,3,111
18228,57,30,779.9,2,2,2,6,222
18229,12,164,7276.9,3,3,3,9,333
18230,9,86,2810.2,3,3,3,9,333
18231,192,123,2071.77,1,3,3,7,133
18232,82,37,592.97,2,2,2,6,222
18233,326,1,440,1,1,2,4,112
18235,72,104,1796.48,2,3,3,8,233
18236,30,49,882.24,2,2,2,6,222
18237,3,61,987.1,3,2,2,7,322
18239,219,88,1561.61,1,3,3,7,133
18240,46,6,422.58,2,1,2,5,212
18241,10,104,2073.09,3,3,3,9,333
18242,72,78,2232.49,2,3,3,8,233
18245,7,175,2567.06,3,3,3,9,333
18246,24,4,596.1,3,1,2,6,312
18248,123,47,804.02,1,2,2,5,122
18249,17,8,95.34,3,1,1,5,311
18250,310,21,349.27,1,1,1,3,111
18251,87,16,4314.72,2,1,3,6,213
18252,51,94,518.27,2,3,2,7,232
18255,89,6,103.3,2,1,1,4,211
18257,39,118,2337.63,2,3,3,8,233
18259,25,42,2338.6,3,2,3,8,323
18260,173,133,2628.35,1,3,3,7,133
18261,43,21,324.24,2,1,1,4,211
18262,140,13,149.48,1,1,1,3,111
18263,26,61,1213.16,2,2,3,7,223
18265,72,46,801.51,2,2,2,6,222
18268,134,1,25.5,1,1,1,3,111
18269,366,7,168.6,1,1,1,3,111
18270,38,11,283.15,2,1,1,4,211
18272,3,166,3078.58,3,3,3,9,333
18273,2,3,204,3,1,1,5,311
18274,30,11,175.92,2,1,1,4,211
18276,44,14,335.86,2,1,1,4,211
18277,58,8,110.38,2,1,1,4,211
18278,74,9,173.9,2,1,1,4,211
18280,278,10,180.6,1,1,1,3,111
18281,181,7,80.82,1,1,1,3,111
18282,8,12,178.05,3,1,1,5,311
18283,4,721,2045.53,3,3,3,9,333
18287,43,70,1837.28,2,2,3,7,223